done|do
had|have
been|be
arisen|arise
came|come
lain|lie
swum|swim
shrunk|shrink
sung|sing
withdrawn|withdraw
sunken|sink
sunk|sink
forgiven|forgive
bidden|bid
hurt|hurt
thrust|thrust
broadcast|broadcast
risen|rise
fallen|fall
split|split
spread|spread
fitted|fit
shut|shut
cast|cast
eaten|eat
broken|break
flown|fly
driven|drive
woken|wake
beaten|beat
ridden|ride
rung|ring
hidden|hide
struck|strike
stricken|strike
frozen|freeze
drawn|draw
sprung|spring
run|run
hit|hit
misread|misread
shed|shed
rid|rid
overcome|overcome
offset|offset
overrun|overrun
upset|upset
undercut|undercut
forsaken|forsake
overridden|override
overtaken|overtake
rewritten|rewrite
undone|undo
beset|beset
mistaken|mistake
underwritten|underwrite
bitten|bite
thrown|throw
stolen|steal
shaken|shake
worn|wear
blown|blow
torn|tear
cut|cut
raised|raise
lowered|lower
consented|consent
hesitated|hesitate
proceeded|proceed
aspired|aspire
purported|purport
endeavoured|endeavour
condescended|condescend
deigned|deign
happened|happen
wished|wish
hoped|hope
agreed|agree
pretended|pretend
sworn|swear
prayed|pray
vowed|vow
voted|vote
appeared|appear
seemed|seem
cared|care
asserted|assert
contended|contend
remarked|remark
retorted|retort
intimated|intimate
exclaimed|exclaim
conjectured|conjecture
alleged|allege
surmised|surmise
opined|opine
insinuated|insinuate
supposed|suppose
theorized|theorize
attested|attest
fantasized|fantasize
mused|muse
speculated|speculate
concurred|concur
replied|reply
shouted|shout
whispered|whisper
argued|argue
sighed|sigh
muttered|mutter
testified|testify
commented|comment
responded|respond
hinted|hint
reasoned|reason
bragged|brag
dreamed|dream
complained|complain
thought|think
mattered|matter
sufficed|suffice
insisted|insist
wondered|wonder
inquired|inquire
gone|go
stayed|stay
acted|act
sounded|sound
looked|look
repented|repent
disapproved|disapprove
talked|talk
consisted|consist
died|die
lasted|last
waited|wait
attempted|attempt
undertaken|undertake
deserved|deserve
managed|manage
plotted|plot
preferred|prefer
neglected|neglect
afforded|afford
committed|commit
professed|profess
desired|desire
sought|seek
declined|decline
failed|fail
hastened|hasten
volunteered|volunteer
aimed|aim
fought|fight
threatened|threaten
meant|mean
arranged|arrange
resolved|resolve
pledged|pledge
planned|plan
confessed|confess
decided|decide
remembered|remember
forgotten|forget
learned|learn
proposed|propose
demanded|demand
begged|beg
pleaded|plead
born|bear
loved|love
disliked|dislike
hated|hate
begun|begin
continued|continue
ceased|cease
started|start
stopped|stop
tried|try
recognized|recognize
disputed|dispute
accepted|accept
calculated|calculate
recorded|record
deduced|deduce
envisioned|envision
recounted|recount
signified|signify
clarified|clarify
disclosed|disclose
recollected|recollect
adduced|adduce
posited|posit
reiterated|reiterate
inferred|infer
presupposed|presuppose
repeated|repeat
reflected|reflect
countered|counter
signaled|signal
signalled|signal
provided|provide
doubted|doubt
reaffirmed|reaffirm
sensed|sense
reckoned|reckon
regretted|regret
proclaimed|proclaim
ascertained|ascertain
discerned|discern
stipulated|stipulate
affirmed|affirm
certified|certify
trusted|trust
postulated|postulate
ensured|ensure
implied|imply
verified|verify
boasted|boast
declared|declare
imagined|imagine
feared|fear
concluded|conclude
suspected|suspect
conceded|concede
presumed|presume
emphasized|emphasize
maintained|maintain
acknowledged|acknowledge
noted|note
confirmed|confirm
stressed|stress
assumed|assume
foreseen|foresee
believed|believe
answered|answer
worried|worry
protested|protest
ruled|rule
added|add
figured|figure
predicted|predict
realized|realize
discovered|discover
determined|determine
announced|announce
said|say
mentioned|mention
admitted|admit
recalled|recall
revealed|reveal
stated|state
observed|observe
indicated|indicate
guessed|guess
estimated|estimate
understood|understand
noticed|notice
explained|explain
demonstrated|demonstrate
known|know
requested|request
felt|feel
minded|mind
studied|study
discussed|discuss
opposed|oppose
enjoyed|enjoy
advocated|advocate
contemplated|contemplate
entailed|entail
necessitated|necessitate
justified|justify
risked|risk
avoided|avoid
involved|involve
anticipated|anticipate
favored|favor
finished|finish
practiced|practice
resisted|resist
quitted|quit
turned|turn
become|become
remained|remain
grown|grow
approved|approve
disposed|dispose
conceived|conceive
spoken|speak
tasted|taste
smelled|smell
taken|take
put|put
cost|cost
found|find
gotten|get
left|leave
kept|keep
paced|pace
watched|watch
tracked|track
set|set
loosed|loose
freed|free
held|hold
hostaged|hostage
expected|expect
claimed|claim
intended|intend
dared|dare
liked|like
offered|offer
refused|refuse
wanted|want
needed|need
chosen|choose
prepared|prepare
pressed|press
required|require
commanded|command
ordered|order
urged|urge
considered|consider
perceived|perceive
reported|report
cautioned|caution
warned|warn
advised|advise
heard|hear
seen|see
owed|owe
delivered|deliver
accorded|accord
awarded|award
termed|term
granted|grant
begrudged|begrudge
assigned|assign
renamed|rename
repaid|repay
dubbed|dub
entitled|entitle
fined|fine
given|give
sent|send
bought|buy
brought|bring
lent|lend
issued|issue
handed|hand
passed|pass
paid|pay
sold|sell
dealt|deal
called|call
read|read
written|write
charged|charge
allowed|allow
promised|promise
shown|show
taught|teach
compelled|compel
forced|force
designed|design
permitted|permit
authorized|authorize
caused|cause
enabled|enable
pressured|pressure
trained|train
sentenced|sentence
prompted|prompt
spurred|spur
invited|invite
reelected|reelect
encouraged|encourage
drafted|draft
hired|hire
enticed|entice
inspired|inspire
aided|aid
forbidden|forbid
employed|employ
educated|educate
tempted|tempt
condemned|condemn
commissioned|commission
counseled|counsel
induced|induce
instructed|instruct
licensed|license
incited|incite
nominated|nominate
destined|destine
provoked|provoke
challenged|challenge
exhorted|exhort
implored|implore
motivated|motivate
impelled|impel
used|use
elected|elect
appointed|appoint
named|name
programmed|program
obliged|oblige
convinced|convince
persuaded|persuade
told|tell
asked|ask
helped|help
reminded|remind
informed|inform
reassured|reassure
alerted|alert
guaranteed|guarantee
notified|notify
forewarned|forewarn
assured|assure
let|let
watched|watch
appreciated|appreciate
spent|spend
made|make
rendered|render
deemed|deem
deprived|deprive
accused|accuse
acquitted|acquit
purged|purge
disabused|disabuse
exonerated|exonerate
absolved|absolve
robbed|rob
convicted|convict
cleared|clear
betted|bet
bothered|bother
surprised|surprise
alarmed|alarm
amazed|amaze
amused|amuse
astonished|astonish
astounded|astound
excited|excite
depressed|depress
disgusted|disgust
distressed|distress
dismayed|dismay
irritated|irritate
embarrassed|embarrass
annoyed|annoy
proven|prove
suggested|suggest
recommended|recommend
denied|deny
described|describe
portrayed|portray
depicted|depict
regarded|regard
viewed|view
characterized|characterize
read|read
written|write
seemed|seem
appeared|appear
said|say
told|tell
asked|ask
said|say
voted|vote
doubled|double
tripled|triple
quadrupled|quadruple
quintupled|quintuple
abated|abate
abounded|abound
about-faced|about-face
absconded|abscond
abstained|abstain
acceded|accede
accounted|account
accrued|accrue
ached|ache
acquiesced|acquiesce
ad-libbed|ad-lib
adhered|adhere
adjoined|adjoin
alighted|alight
allied|allude
alluded|ally
amounted|amount
apologized|apologize
appertained|appertain
aquaplaned|aquaplane
arose|arise
arrived|arrive
assented|assent
atoned|atone
atrophied|atrophy
baaed|baa
babbled|babble
babysat|babysit
backfired|backfire
backpedalled|backpedal
backslid|backslide
backspaced|backspace
balked|balk
ballooned|balloon
banqueted|banquet
bantered|banter
barked|bark
barnstormed|barnstorm
basked|bask
bawled|bawl
bayed|bay
beetled|beetle
behaved|behave
belched|belch
bellyached|bellyache
belonged|belong
bickered|bicker
bicycled|bicycle
billowed|billow
blabbered|blabber
blathered|blather
blazed|blaze
bleated|bleat
bled|bleed
bleeped|bleep
bloomed|bloom
blossomed|blossom
blubbered|blubber
blundered|blunder
blushed|blush
boded|bode
boomed|boom
braked|brake
brawled|brawl
brayed|bray
bristled|bristle
brooded|brood
browsed|browse
bubbled|bubble
budded|bud
bullshitted|bullshit
bunked|bunk
burbled|burble
burgeoned|burgeon
burped|burp
bustled|bustle
cackled|cackle
campaigned|campaign
canoed|canoe
cantered|canter
capered|caper
capitulated|capitulate
careened|careen
carolled|carol
caroused|carouse
cascaded|cascade
castled|castle
catered|cater
caterwauled|caterwaul
cavilled|cavil
cavorted|cavort
chafed|chafe
chattered|chatter
cheeped|cheep
chirped|chirp
chirruped|chirrup
chortled|chortle
chuckled|chuckle
chugged|chug
chummed|chum
clacked|clack
clambered|clamber
clamored|clamor
clamoured|clamour
clanked|clank
clashed|clash
clattered|clatter
clerked|clerk
climaxed|climax
clung|cling
clucked|cluck
clunked|clunk
clustered|cluster
co-operated|co-operate
coalesced|coalesce
coasted|coast
coexisted|coexist
cohabited|cohabit
cohered|cohere
coincided|coincide
collaborated|collaborate
collided|collide
commentated|commentate
commiserated|commiserate
communed|commune
competed|compete
complied|comply
compromised|compromise
confabbed|confab
confabulated|confabulate
conflicted|conflict
conformed|conform
congealed|congeal
congregated|congregate
connived|connive
consorted|consort
conspired|conspire
convalesced|convalesce
converged|converge
conversed|converse
cooed|coo
cooperated|cooperate
coped|cope
copulated|copulate
corresponded|correspond
cowered|cower
crackled|crackle
crash-dived|crash-dive
creaked|creak
crested|crest
cringed|cringe
croaked|croak
crowed|crow
crusaded|crusade
culminated|culminate
curtseyed|curtsey
curtsied|curtsy
cycled|cycle
dabbled|dabble
dallied|dally
dawdled|dawdle
dawned|dawn
daydreamed|daydream
decamped|decamp
decayed|decay
defaulted|default
defecated|defecate
defected|defect
degenerated|degenerate
deliberated|deliberate
delved|delve
demurred|demur
departed|depart
depended|depend
deplaned|deplane
depreciated|depreciate
deputized|deputize
desisted|desist
despaired|despair
deteriorated|deteriorate
detracted|detract
deviated|deviate
devolved|devolve
dieted|diet
differed|differ
digressed|digress
dilly-dallied|dilly-dally
disagreed|disagree
disappeared|disappear
discoursed|discourse
discriminated|discriminate
disembarked|disembark
disintegrated|disintegrate
disrobed|disrobe
dissembled|dissemble
dissented|dissent
dithered|dither
diverged|diverge
doddered|dodder
domineered|domineer
doodled|doodle
doted|dote
double-parked|double-park
dovetailed|dovetail
drawled|drawl
drizzled|drizzle
drooled|drool
duelled|duel
dwelt|dwell
dwindled|dwindle
eavesdropped|eavesdrop
ebbed|ebb
economized|economize
eddied|eddy
effervesced|effervesce
elapsed|elapse
eloped|elope
emanated|emanate
embarked|embark
emerged|emerge
emigrated|emigrate
encamped|encamp
encroached|encroach
enquired|enquire
ensued|ensue
erred|err
erupted|erupt
evaporated|evaporate
excelled|excel
existed|exist
exited|exit
expatiated|expatiate
experimented|experiment
expired|expire
expostulated|expostulate
exulted|exult
fainted|faint
faltered|falter
fared|fare
farted|fart
fasted|fast
fawned|fawn
feinted|feint
festered|fester
fibbed|fib
fidgeted|fidget
filibustered|filibuster
fizzed|fizz
flailed|flail
flaked|flake
flamed|flame
flickered|flicker
flinched|flinch
flirted|flirt
flitted|flit
flopped|flop
floundered|flounder
flourished|flourish
flowered|flower
fluctuated|fluctuate
fluttered|flutter
fly-fished|fly-fish
foraged|forage
foregathered|foregather
fornicated|fornicate
fossilized|fossilize
foxhunted|foxhunt
fragmented|fragment
fraternized|fraternize
freelanced|freelance
freewheeled|freewheel
fretted|fret
frothed|froth
frowned|frown
fulminated|fulminate
fumed|fume
functioned|function
fussed|fuss
gallivanted|gallivant
galumphed|galumph
gambolled|gambol
gaped|gape
gardened|garden
gawped|gawp
gazed|gaze
gelled|gel
genuflected|genuflect
gesticulated|gesticulate
gestured|gesture
gibed|gibe
giggled|giggle
glared|glare
gleamed|gleam
glided|glide
glimmered|glimmer
glinted|glint
glistened|glisten
glittered|glitter
gloated|gloat
globetrotted|globetrot
gloried|glory
glowed|glow
glowered|glower
goggled|goggle
golfed|golf
gossiped|gossip
graduated|graduate
grappled|grapple
gravitated|gravitate
grayed|gray
grazed|graze
greyed|grey
grimaced|grimace
grinned|grin
grooved|groove
grouched|grouch
groused|grouse
grovelled|grovel
guffawed|guffaw
gurgled|gurgle
gybed|gybe
gyrated|gyrate
haggled|haggle
hankered|hanker
harked|hark
harped|harp
hawed|haw
hearkened|hearken
heeled|heel
hibernated|hibernate
hiccoughed|hiccough
hiccupped|hiccup
hinged|hinge
hissed|hiss
hitchhiked|hitchhike
hobnobbed|hobnob
hollered|holler
honeymooned|honeymoon
hovered|hover
huddled|huddle
huffed|huff
hungered|hunger
hurtled|hurtle
ice-skated|ice-skate
immigrated|immigrate
impended|impend
impinged|impinge
inched|inch
innovated|innovate
interacted|interact
interceded|intercede
intercommunicated|intercommunicate
interfered|interfere
intermarried|intermarry
intermingled|intermingle
intervened|intervene
introspected|introspect
intruded|intrude
inveighed|inveigh
itched|itch
jabbered|jabber
jack-knifed|jack-knife
jaunted|jaunt
jawed|jaw
jaywalked|jaywalk
jelled|jell
jested|jest
jibed|jibe
jived|jive
jockeyed|jockey
joked|joke
journeyed|journey
jousted|joust
kowtowed|kowtow
lagged|lag
languished|languish
lapsed|lapse
laughed|laugh
leafed|leaf
leered|leer
legislated|legislate
liaised|liaise
lip-read|lip-read
lisped|lisp
lived|live
loafed|loaf
loitered|loiter
lolled|loll
longed|long
loped|lope
lounged|lounge
lumbered|lumber
lurked|lurk
lusted|lust
luxuriated|luxuriate
majored|major
malfunctioned|malfunction
malingered|malinger
marvelled|marvel
masqueraded|masquerade
materialized|materialize
matriculated|matriculate
maturated|maturate
matured|mature
maundered|maunder
meandered|meander
meddled|meddle
meditated|meditate
menstruated|menstruate
metamorphosed|metamorphose
mewed|mew
miaoued|miaou
miaowed|miaow
migrated|migrate
militated|militate
mingled|mingle
ministered|minister
misbehaved|misbehave
misfired|misfire
molted|molt
monkeyed|monkey
mooed|moo
mooched|mooch
moped|mope
moralized|moralize
moseyed|mosey
motioned|motion
motored|motor
mushroomed|mushroom
mutinied|mutiny
name-dropped|name-drop
napped|nap
nattered|natter
necked|neck
neighed|neigh
nested|nest
networked|network
niggled|niggle
nosedived|nosedive
noshed|nosh
objected|object
occurred|occur
officiated|officiate
orated|orate
oscillated|oscillate
outgone|outgo
overacted|overact
overbidden|overbid
overeaten|overeat
overlain|overlie
overreacted|overreact
overslept|oversleep
paled|pale
palled|pall
palpitated|palpitate
pandered|pander
panhandled|panhandle
panicked|panic
panted|pant
parachuted|parachute
parleyed|parley
partaken|partake
participated|participate
pattered|patter
paused|pause
peaked|peak
pearled|pearl
peeped|peep
perambulated|perambulate
percolated|percolate
perished|perish
persevered|persevere
persisted|persist
perspired|perspire
pertained|pertain
philandered|philander
philosophized|philosophize
picnicked|picnic
piddled|piddle
pimped|pimp
pinged|ping
pirouetted|pirouette
pivoted|pivot
plodded|plod
plummetted|plummet
politicked|politick
pontificated|pontificate
pored|pore
postured|posture
pottered|potter
pounced|pounce
pouted|pout
powwowed|powwow
pranced|prance
prated|prate
prattled|prattle
pre-existed|pre-exist
predominated|predominate
presided|preside
prevailed|prevail
prevaricated|prevaricate
preyed|prey
primped|primp
procrastinated|procrastinate
procreated|procreate
profited|profit
profiteered|profiteer
progressed|progress
proliferated|proliferate
propagandized|propagandize
proselytized|proselytize
prospered|prosper
protruded|protrude
pub-crawled|pub-crawl
pulsated|pulsate
pulsed|pulse
punned|pun
purred|purr
pussyfooted|pussyfoot
putrefied|putrefy
puttered|putter
quacked|quack
quaked|quake
quarreled|quarrel
quarried|quarry
quavered|quaver
quested|quest
queued|queue
quibbled|quibble
quipped|quip
quivered|quiver
racketed|racket
rafted|raft
raged|rage
railed|rail
rained|rain
rambled|ramble
rampaged|rampage
ranged|range
rankled|rankle
ranted|rant
rasped|rasp
ratted|rat
raved|rave
re-echoed|re-echo
reacted|react
reappeared|reappear
rebelled|rebel
rebounded|rebound
receded|recede
reclined|recline
recoiled|recoil
reconnoitred|reconnoitre
reconverted|reconvert
recriminated|recriminate
recuperated|recuperate
recurred|recur
redounded|redound
refrained|refrain
regressed|regress
reigned|reign
rejoiced|rejoice
relapsed|relapse
relented|relent
relied|rely
reminisced|reminisce
remonstrated|remonstrate
rendezvoused|rendezvous
reneged|renege
resided|reside
resigned|resign
resonated|resonate
resorted|resort
resounded|resound
rested|rest
resulted|result
resurfaced|resurface
retaliated|retaliate
retched|retch
retreated|retreat
retrenched|retrench
retrograded|retrograde
retrogressed|retrogress
revelled|revel
reverberated|reverberate
reverted|revert
revolted|revolt
revolved|revolve
rhapsodized|rhapsodize
rioted|riot
ripened|ripen
riposted|riposte
rippled|ripple
rocketed|rocket
romanced|romance
romped|romp
roomed|room
roosted|roost
rough-housed|rough-house
roved|rove
rumbled|rumble
ruminated|ruminate
rummaged|rummage
rusted|rust
sagged|sag
salivated|salivate
sauntered|saunter
scampered|scamper
scavenged|scavenge
schemed|scheme
scintillated|scintillate
scowled|scowl
scrammed|scram
screeched|screech
scrimped|scrimp
scrounged|scrounge
scuffled|scuffle
seceded|secede
seesawed|seesaw
seethed|seethe
sermonized|sermonize
shillyshallied|shillyshally
shimmered|shimmer
shitted|shit
shivered|shiver
shrimped|shrimp
shuddered|shudder
sided|side
sidled|sidle
simmered|simmer
simpered|simper
sinned|sin
sizzled|sizzle
skated|skate
skedaddled|skedaddle
skimped|skimp
skirmished|skirmish
skulked|skulk
skylarked|skylark
skyrocketed|skyrocket
slackened|slacken
slavered|slaver
slept|sleep
sleeted|sleet
slithered|slither
slobbered|slobber
slogged|slog
slouched|slouch
slummed|slum
slumbered|slumber
smarted|smart
smiled|smile
smirked|smirk
smouldered|smoulder
snaked|snake
sneered|sneer
sneezed|sneeze
snickered|snicker
sniffled|sniffle
sniggered|snigger
sniped|snipe
snitched|snitch
snivelled|snivel
snooped|snoop
snoozed|snooze
snored|snore
snowed|snow
snowballed|snowball
snuffled|snuffle
sobbed|sob
sojourned|sojourn
soliloquized|soliloquize
somersaulted|somersault
soured|sour
sparred|spar
sparkled|sparkle
specialized|specialize
speechified|speechify
spiralled|spiral
splurged|splurge
spluttered|splutter
sprawled|sprawl
sprinted|sprint
sputtered|sputter
squabbled|squabble
squalled|squall
squawked|squawk
squeaked|squeak
squealed|squeal
squinted|squint
squirmed|squirm
stagnated|stagnate
stemmed|stem
straggled|straggle
strayed|stray
strived|strive
struggled|struggle
stuttered|stutter
subbed|sub
subscribed|subscribe
subsided|subside
subsisted|subsist
succumbed|succumb
sulked|sulk
summered|summer
sunbathed|sunbathe
supped|sup
supervened|supervene
surfaced|surface
surged|surge
swaggered|swagger
swarmed|swarm
sweltered|swelter
swerved|swerve
swirled|swirl
swooned|swoon
sympathized|sympathize
tampered|tamper
tarried|tarry
tattled|tattle
taxied|taxi
teemed|teem
teetered|teeter
teethed|teethe
temporized|temporize
thrived|thrive
throbbed|throb
thudded|thud
tingled|tingle
tinkered|tinker
tinkled|tinkle
tiptoed|tiptoe
tittered|titter
tittle-tattled|tittle-tattle
toadied|toady
tobogganed|toboggan
toiled|toil
tolled|toll
tootled|tootle
tonned|ton
tottered|totter
touch-typed|touch-type
towered|tower
toyed|toy
traipsed|traipse
transpired|transpire
traveled|travel
travelled|travel
trekked|trek
trembled|tremble
trespassed|trespass
trifled|trifle
triumphed|triumph
trundled|trundle
tunnelled|tunnel
tussled|tussle
tweeted|tweet
twinkled|twinkle
twitched|twitch
twittered|twitter
ululated|ululate
underacted|underact
undulated|undulate
urinated|urinate
vacationed|vacation
vacillated|vacillate
vamoosed|vamoose
vamped|vamp
vanished|vanish
vaulted|vault
vegetated|vegetate
verged|verge
vied|vie
vouched|vouch
voyaged|voyage
waddled|waddle
waffled|waffle
wallowed|wallow
waltzed|waltz
wandered|wander
waned|wane
wanked|wank
warbled|warble
wavered|waver
wept|weep
welshed|welsh
weltered|welter
wheezed|wheeze
whimpered|whimper
whinnied|whinny
whirred|whir
whirred|whirr
wilted|wilt
winced|wince
winked|wink
wiretapped|wiretap
wisecracked|wisecrack
withered|wither
wobbled|wobble
womanized|womanize
wrangled|wrangle
wriggled|wriggle
writhed|writhe
yachted|yacht
yammered|yammer
yapped|yap
yawned|yawn
yearned|yearn
yelped|yelp
yenned|yen
zigzagged|zigzag
abdicated|abdicate
abided|abide
aborted|abort
accelerated|accelerate
acclimateed|acclimate
acclimatized|acclimatize
accumulated|accumulate
acidified|acidify
adapted|adapt
adjourned|adjourn
adjudicated|adjudicate
adjusted|adjust
advanced|advance
advertised|advertise
affiliated|affiliate
aged|age
aggregated|aggregate
agitateed|agitate
ailed|ail
aligned|align
altered|alter
alternated|alternate
amalgamated|amalgamate
anchored|anchor
angled|angle
appealed|appeal
applauded|applaud
applied|apply
approached|approach
approximated|approximate
arbitrated|arbitrate
arched|arch
articulated|articulate
ascended|ascend
assembled|assemble
assimilated|assimilate
assisted|assist
associated|associate
attended|attend
auditioned|audition
augured|augur
availed|avail
awakened|awaken
bagged|bag
banded|band
banked|bank
bargained|bargain
bartered|barter
batted|bat
bathed|bath
bathed|bathe
baulked|baulk
beckoned|beckon
benefited|benefit
berthed|berth
bifurcated|bifurcate
blabbed|blab
blackened|blacken
blanched|blanch
blasphemeed|blaspheme
bleached|bleach
blended|blend
blinked|blink
blistered|blister
bluffed|bluff
blurred|blur
boggled|boggle
bonded|bond
boned|bone
booed|boo
bordered|border
borrowed|borrow
breastfed|breastfeed
bred|breed
brewed|brew
bridled|bridle
broadcasted|broadcast
broadened|broaden
broiled|broil
browned|brown
budged|budge
buffeted|buffet
buggered|bugger
bullied|bully
burgled|burgle
burnished|burnish
burrowed|burrow
cabled|cable
calcified|calcify
canceled|cancel
cancelled|cancel
canvassed|canvass
capitalized|capitalize
capsized|capsize
carped|carp
celebrated|celebrate
centered|center
centred|centre
chanted|chant
charred|char
circled|circle
circulated|circulate
clanged|clang
clapped|clap
clasped|clasp
cleaved|cleave
clinched|clinch
clinked|clink
clotted|clot
cloyed|cloy
clutched|clutch
co-starred|co-star
coached|coach
coagulated|coagulate
coaxed|coax
cogitated|cogitate
collapsed|collapse
combined|combine
commenced|commence
commingled|commingle
communicated|communicate
commuted|commute
compared|compare
compensated|compensate
composed|compose
computed|compute
concentrated|concentrate
condensed|condense
conducted|conduct
confederated|confederate
conferred|confer
confided|confide
conjoined|conjoin
conjugated|conjugate
consolidated|consolidate
consulted|consult
contested|contest
contrasted|contrast
contributed|contribute
convened|convene
converted|convert
correlated|correlate
corroded|corrode
corrupted|corrupt
couched|couch
counterattacked|counterattack
crashed|crash
crash-landed|crash-land
craved|crave
creased|crease
cribbed|crib
crinkled|crinkle
crisscrossed|crisscross
crocheted|crochet
crooned|croon
crosschecked|crosscheck
crystallized|crystallize
cuddled|cuddle
curdled|curdle
cursed|curse
curved|curve
dabbed|dab
damped|damp
dangled|dangle
darkened|darken
darned|darn
dated|date
debarked|debark
debated|debate
decelerated|decelerate
decomposed|decompose
decreased|decrease
deepened|deepen
deflected|deflect
delayed|delay
delighted|delight
democratized|democratize
derailed|derail
derived|derive
derogated|derogate
descended|descend
detonated|detonate
developed|develop
dictated|dictate
differentiated|differentiate
diffused|diffuse
digested|digest
dilated|dilate
dimmed|dim
diminished|diminish
dinned|din
dipped|dip
disarmed|disarm
disbanded|disband
discharged|discharge
discontinued|discontinue
disengaged|disengage
disentangled|disentangle
dismounted|dismount
dispensed|dispense
dispersed|disperse
dissipated|dissipate
dissolved|dissolve
distended|distend
distinguished|distinguish
dive-bombed|dive-bomb
diversified|diversify
divined|divine
docked|dock
dodged|dodge
dreaded|dread
dribbled|dribble
drilled|drill
dripped|drip
drooped|droop
dulled|dull
echoed|echo
ejaculated|ejaculate
ejected|eject
elaborated|elaborate
elongated|elongate
embroidered|embroider
ended|end
endured|endure
engaged|engage
enlisted|enlist
enroled|enrol
enrolled|enroll
entered|enter
entertained|entertain
enunciated|enunciate
eroded|erode
escalated|escalate
escaped|escape
etched|etch
evacuated|evacuate
evolved|evolve
exaggerated|exaggerate
exercised|exercise
exhaled|exhale
expanded|expand
exploded|explode
explored|explore
expounded|expound
extemporized|extemporize
extended|extend
extrapolated|extrapolate
fastened|fasten
feasted|feast
fermented|ferment
ferried|ferry
fiddled|fiddle
fielded|field
filmed|film
fitted|fit
fixated|fixate
flagged|flag
flapped|flap
flashed|flash
fled|flee
focused|focus
footed|foot
forborne|forbear
foreclosed|foreclose
forgiven|forgive
formed|form
foundered|founder
fractured|fracture
frayed|fray
fronted|front
frosted|frost
fuelled|fuel
fumbled|fumble
furled|furl
fused|fuse
gagged|gag
gained|gain
gambled|gamble
gargled|gargle
gasified|gasify
gasped|gasp
generalized|generalize
germinated|germinate
glanced|glance
glossed|gloss
gnashed|gnash
gnawed|gnaw
governed|govern
grasped|grasp
grated|grate
grieved|grieve
ground|grind
groaned|groan
grounded|ground
groped|grope
grouped|group
growled|growl
grumbled|grumble
grunted|grunt
hailed|hail
hardened|harden
harmonized|harmonize
hatched|hatch
heaved|heave
heckled|heckle
hedged|hedge
heightened|heighten
hemmed|hem
hoarded|hoard
hoed|hoe
honked|honk
hooted|hoot
howled|howl
hugged|hug
hummed|hum
hurt|hurt
hushed|hush
hustled|hustle
iced|ice
idled|idle
ignited|ignite
improved|improve
improvised|improvise
inclined|incline
incorporated|incorporate
increased|increase
incubated|incubate
indented|indent
indulged|indulge
industrialized|industrialize
infringed|infringe
inhaled|inhale
intensified|intensify
interbred|interbreed
interconnected|interconnect
interlocked|interlock
intermixed|intermix
interned|intern
interpreted|interpret
interrelated|interrelate
interrupted|interrupt
intersected|intersect
intertwined|intertwine
interviewed|interview
intrigued|intrigue
invested|invest
investigated|investigate
ionized|ionize
jabbed|jab
jangled|jangle
jeered|jeer
jigged|jig
jiggled|jiggle
jingled|jingle
jolted|jolt
jostled|jostle
judged|judge
juggled|juggle
kidded|kid
kindled|kindle
knitted|knit
laboured|labour
lamented|lament
landed|land
latched|latch
launched|launch
lectured|lecture
lengthened|lengthen
lessened|lessen
leveled|level
levelled|level
levitated|levitate
lighted|light
liquefied|liquefy
liquidated|liquidate
litigated|litigate
littered|litter
lobbied|lobby
located|locate
lodged|lodge
looped|loop
lunched|lunch
maneuvered|maneuver
manoeuvred|manoeuvre
marinated|marinate
massed|mass
masturbated|masturbate
mated|mate
mediated|mediate
met|meet
mended|mend
merged|merge
meshed|mesh
milled|mill
mimed|mime
mined|mine
miscalculated|miscalculate
miscarried|miscarry
miscounted|miscount
misdealt|misdeal
misjudged|misjudge
misted|mist
misunderstood|misunderstand
moaned|moan
mobilized|mobilize
modeled|model
modelled|model
moderated|moderate
modernized|modernize
moistened|moisten
mooned|moon
moulded|mould
moulted|moult
mounted|mount
mourned|mourn
mowed|mow
muddled|muddle
multiplied|multiply
mumbled|mumble
munched|munch
murmured|murmur
narrowed|narrow
navigated|navigate
neared|near
negotiated|negotiate
nibbled|nibble
nipped|nip
nuzzled|nuzzle
obeyed|obey
obsessed|obsess
ogled|ogle
operated|operate
orbited|orbit
originated|originate
ossified|ossify
overcharged|overcharge
overdrawn|overdraw
overdressed|overdress
overfed|overfeed
overflowed|overflow
overheated|overheat
overindulged|overindulge
overlapped|overlap
overproduced|overproduce
overreached|overreach
overspent|overspend
overtrumped|overtrump
overturned|overturn
overworked|overwork
oxidized|oxidize
paced|pace
paddled|paddle
painted|paint
paraded|parade
parked|park
parted|part
pealed|peal
pecked|peck
pedalled|pedal
peddled|peddle
penetrated|penetrate
perched|perch
performed|perform
petitioned|petition
petrified|petrify
picketed|picket
pillaged|pillage
pioneered|pioneer
pitched|pitch
plundered|plunder
poached|poach
poised|poise
polled|poll
posed|pose
practised|practise
preached|preach
privatized|privatize
programed|program
programmed|programme
projected|project
promenaded|promenade
proofread|proofread
propagated|propagate
prowled|prowl
puked|puke
punctured|puncture
punted|punt
putted|putt
puzzled|puzzle
qualified|qualify
quickened|quicken
quietened|quieten
raced|race
radiated|radiate
radioed|radio
rallied|rally
ramified|ramify
ranked|rank
rapped|rap
rated|rate
rattled|rattle
ravelled|ravel
re-formed|re-form
re-opened|re-open
readjusted|readjust
reared|rear
rearmed|rearm
reassembled|reassemble
rebuilt|rebuild
recanted|recant
recapped|recap
recapitulated|recapitulate
received|receive
reciprocated|reciprocate
reconvened|reconvene
reconverted|reconvert
recovered|recover
recruited|recruit
reddened|redden
redoubled|redouble
referred|refer
reformed|reform
refuelled|refuel
regenerated|regenerate
registered|register
regrouped|regroup
rehearsed|rehearse
reinvested|reinvest
rekindled|rekindle
related|relate
relaxed|relax
relocated|relocate
remarried|remarry
remitted|remit
remounted|remount
renegotiated|renegotiate
reopened|reopen
reorganized|reorganize
repaired|repair
reproduced|reproduce
resettled|resettle
restarted|restart
resumed|resume
resuscitated|resuscitate
retailed|retail
retired|retire
retooled|retool
returned|return
reunited|reunite
reversed|reverse
revived|revive
rhymed|rhyme
ricocheted|ricochet
ringed|ring
rung|ring
roamed|roam
roared|roar
roasted|roast
rotated|rotate
roused|rouse
rowed|row
ruffled|ruffle
ruptured|rupture
rustled|rustle
sacrificed|sacrifice
saluted|salute
sawed|saw
scanned|scan
scattered|scatter
scoffed|scoff
scolded|scold
scored|score
scrambled|scramble
scrawled|scrawl
scribbled|scribble
scrubbed|scrub
sculptured|sculpture
searched|search
seized|seize
separated|separate
severed|sever
shaded|shade
shattered|shatter
shelled|shell
shoplifted|shoplift
short-circuited|short-circuit
shortened|shorten
shoved|shove
showered|shower
shrieked|shriek
shrunk|shrink
shrunken|shrink
shuffled|shuffle
sifted|sift
sung|sing
singed|singe
sunk|sink
sunken|sink
sipped|sip
slammed|slam
slanted|slant
sloshed|slosh
smacked|smack
smeared|smear
smoked|smoke
smudged|smudge
snarled|snarl
snipped|snip
snorted|snort
snuggled|snuggle
socialized|socialize
solidified|solidify
sowed|sow
spattered|spatter
spawned|spawn
splashed|splash
splayed|splay
splintered|splinter
spoiled|spoil
sponged|sponge
sported|sport
spouted|spout
spring-cleaned|spring-clean
spied|spy
squashed|squash
stabilized|stabilize
stained|stain
stalked|stalk
stalled|stall
stammered|stammer
stampeded|stampede
stared|stare
steadied|steady
steeped|steep
steepened|steepen
steered|steer
stewed|stew
stifled|stifle
stung|sting
stinted|stint
stonewalled|stonewall
strained|strain
stratified|stratify
streaked|streak
strengthened|strengthen
strummed|strum
stumped|stump
subcontracted|subcontract
subdivided|subdivide
subleased|sublease
sublet|sublet
submerged|submerge
submitted|submit
substituted|substitute
succeeded|succeed
sued|sue
suffered|suffer
suffocated|suffocate
supervised|supervise
supplicated|supplicate
surrendered|surrender
survived|survive
swallowed|swallow
swapped|swap
swayed|sway
sweated|sweat
swished|swish
swivelled|swivel
synchronized|synchronize
tackled|tackle
tagged|tag
tanned|tan
tapped|tap
tarnished|tarnish
telegraphed|telegraph
telephoned|telephone
tended|tend
terminated|terminate
thawed|thaw
thrashed|thrash
thrilled|thrill
thronged|throng
throttled|throttle
thumped|thump
thundered|thunder
tickled|tickle
tilted|tilt
toasted|toast
tooted|toot
traced|trace
traded|trade
transferred|transfer
transgressed|transgress
translated|translate
transplanted|transplant
treated|treat
trebled|treble
trotted|trot
trumped|trump
trumpeted|trumpet
tugged|tug
twirled|twirl
umpired|umpire
unbended|unbend
uncurled|uncurl
underbidden|underbid
underspent|underspend
undressed|undress
unfastened|unfasten
unfolded|unfold
unhitched|unhitch
unified|unify
united|unite
unloaded|unload
unlocked|unlock
unpacked|unpack
unraveled|unravel
unrolled|unroll
unscrewed|unscrew
untied|untie
unwound|unwind
unwrapped|unwrap
urbanized|urbanize
vaporized|vaporize
varied|vary
ventured|venture
vested|vest
vibrated|vibrate
visited|visit
volleyed|volley
vomited|vomit
waded|wade
wagged|wag
wailed|wail
wakened|waken
warped|warp
watered|water
waved|wave
waxed|wax
weakened|weaken
wedded|wed
welded|weld
wheeled|wheel
whined|whine
whirled|whirl
whistled|whistle
whitened|whiten
whittled|whittle
widened|widen
wiggled|wiggle
wired|wire
withdrawn|withdraw
worsened|worsen
worshipped|worship
wrestled|wrestle
wrinkled|wrinkle
yelled|yell
yielded|yield
yodelled|yodel
abandoned|abandon
abased|abase
abbreviated|abbreviate
abducted|abduct
abetted|abet
abhorred|abhor
abolished|abolish
abridged|abridge
abrogated|abrogate
absorbed|absorb
abstracted|abstract
abused|abuse
abutted|abut
accented|accent
accentuated|accentuate
accessed|access
acclaimed|acclaim
accommodated|accommodate
accompanied|accompany
accomplished|accomplish
accosted|accost
accredited|accredit
accustomed|accustom
achieved|achieve
acquainted|acquaint
acquired|acquire
activated|activate
addicted|addict
addled|addle
addressed|address
adjudged|adjudge
administered|administer
admired|admire
admonished|admonish
adopted|adopt
adored|adore
adorned|adorn
adulterated|adulterate
adumbrated|adumbrate
aerated|aerate
affected|affect
affixed|affix
afflicted|afflict
aggrandized|aggrandize
aggravated|aggravate
aired|air
alienated|alienate
allayed|allay
alleviated|alleviate
allocated|allocate
allotted|allot
amassed|amass
ambushed|ambush
ameliorated|ameliorate
amended|amend
amortized|amortize
amplified|amplify
amputated|amputate
anaesthetized|anaesthetize
analysed|analyse
analyzed|analyze
anathematized|anathematize
anesthetized|anesthetize
angered|anger
anglicized|anglicize
animated|animate
annexed|annex
annihilated|annihilate
annointed|annoint
annotated|annotate
annulled|annul
anointed|anoint
antagonized|antagonize
antedated|antedate
aped|ape
appalled|appal
appeased|appease
appended|append
apportioned|apportion
appraised|appraise
apprehended|apprehend
apprenticed|apprentice
apprised|apprise
appropriated|appropriate
armed|arm
aroused|arouse
arraigned|arraign
arrayed|array
arrested|arrest
arrogated|arrogate
ascribed|ascribe
asphalted|asphalt
asphyxiated|asphyxiate
aspirated|aspirate
assailed|assail
assassinated|assassinate
assaulted|assault
assayed|assay
assessed|assess
assuaged|assuage
atomized|atomize
attached|attach
attacked|attack
attained|attain
attenuated|attenuate
attired|attire
attracted|attract
attributed|attribute
attuned|attune
audited|audit
augmented|augment
authenticated|authenticate
autographed|autograph
automated|automate
avenged|avenge
averred|aver
averted|avert
awaited|await
awed|awe
axed|ax
axed|axe
backdated|backdate
badgered|badger
baffled|baffle
baited|bait
baked|bake
balanced|balance
baled|bale
bamboozled|bamboozle
banned|ban
bandaged|bandage
banished|banish
bankrupted|bankrupt
baptized|baptize
barbarized|barbarize
barbecued|barbecue
bared|bare
barrelled|barrel
barricaded|barricade
based|base
bashed|bash
basted|baste
battered|batter
battled|battle
beatified|beatify
beautified|beautify
bedevilled|bedevil
befallen|befall
befitted|befit
befouled|befoul
befriended|befriend
begotten|beget
beggared|beggar
beguiled|beguile
beheaded|behead
beheld|behold
belaboured|belabour
belied|belie
belittled|belittle
belted|belt
bemoaned|bemoan
bequeathed|bequeath
berated|berate
bereaved|bereave
beseeched|beseech
besieged|besiege
besmirched|besmirch
bespoken|bespeak
bested|best
bestirred|bestir
bestowed|bestow
bestrewed|bestrew
bestrode|bestride
betokened|betoken
betrayed|betray
bevelled|bevel
bewailed|bewail
bewildered|bewilder
bewitched|bewitch
biased|bias
bided|bide
biffed|biff
bilked|bilk
billed|bill
billeted|billet
birched|birch
bisected|bisect
blackballed|blackball
blacklisted|blacklist
blackmailed|blackmail
blamed|blame
blanketed|blanket
blasted|blast
blazoned|blazon
blemished|blemish
blessed|bless
blighted|blight
blinded|blind
blindfolded|blindfold
blitzed|blitz
blockaded|blockade
blow-dried|blow-dry
bludgeoned|bludgeon
blue-pencilled|blue-pencil
blunted|blunt
bolstered|bolster
bombed|bomb
bombarded|bombard
boosted|boost
bossed|boss
botched|botch
boycotted|boycott
braced|brace
bracketed|bracket
braided|braid
brainwashed|brainwash
braised|braise
branded|brand
brandished|brandish
braved|brave
breached|breach
bribed|bribe
bricked|brick
bridged|bridge
briefed|brief
broached|broach
brocaded|brocade
bronzed|bronze
brooked|brook
browbeaten|browbeat
brutalized|brutalize
budgeted|budget
buffed|buff
bugged|bug
bulldozed|bulldoze
bunged|bung
bungled|bungle
buoyed|buoy
burdened|burden
burlesqued|burlesque
buried|bury
bused|bus
bussed|bus
busied|busy
butchered|butcher
buttonholed|buttonhole
buttressed|buttress
by-passed|by-pass
bypassed|bypass
cajoled|cajole
calibrated|calibrate
camouflaged|camouflage
caned|cane
cannibalized|cannibalize
canonized|canonize
capped|cap
captivated|captivate
captured|capture
carbonized|carbonize
carded|card
caressed|caress
caricatured|caricature
carpeted|carpet
cased|case
castigated|castigate
castrated|castrate
catalogued|catalogue
catapulted|catapult
categorized|categorize
ceded|cede
cemented|cement
censored|censor
censured|censure
centralized|centralize
chagrined|chagrin
chained|chain
chaired|chair
championed|champion
channelled|channel
chaperoned|chaperon
charmed|charm
charted|chart
chartered|charter
chastened|chasten
chastised|chastise
cheapened|cheapen
checkmated|checkmate
cherished|cherish
chided|chide
chiselled|chisel
chlorinated|chlorinate
christened|christen
chronicled|chronicle
circularized|circularize
circumcised|circumcise
circumnavigated|circumnavigate
circumscribed|circumscribe
circumvented|circumvent
cited|cite
civilized|civilize
clamped|clamp
classified|classify
clawed|claw
cleansed|cleanse
clenched|clench
clipped|clip
cloaked|cloak
clobbered|clobber
cloistered|cloister
cloned|clone
closeted|closet
clothed|clothe
clubbed|club
co-authored|co-author
co-opted|co-opt
co-produced|co-produce
coated|coat
cobbled|cobble
cocked|cock
coddled|coddle
coded|code
codified|codify
coerced|coerce
coined|coin
cold-shouldered|cold-shoulder
collared|collar
collated|collate
collected|collect
collectivized|collectivize
colonized|colonize
colored|color
coloured|colour
combated|combat
combatted|combat
comforted|comfort
commandeered|commandeer
commemorated|commemorate
commended|commend
commercialized|commercialize
compacted|compact
compartmentalized|compartmentalize
compiled|compile
complemented|complement
completed|complete
complicated|complicate
complimented|compliment
composted|compost
compounded|compound
comprehended|comprehend
compressed|compress
comprised|comprise
computerized|computerize
conned|con
concealed|conceal
concerned|concern
conciliated|conciliate
concocted|concoct
conditioned|condition
condoned|condone
configured|configure
confined|confine
confiscated|confiscate
confounded|confound
confronted|confront
confused|confuse
confuted|confute
congratulated|congratulate
conked|conk
connoted|connote
conquered|conquer
conscripted|conscript
consecrated|consecrate
conserved|conserve
consigned|consign
consoled|console
constituted|constitute
constrained|constrain
constricted|constrict
constructed|construct
construed|construe
consumed|consume
consummated|consummate
contacted|contact
contained|contain
contaminated|contaminate
contented|content
contorted|contort
contoured|contour
contradicted|contradict
contravened|contravene
contrived|contrive
controlled|control
conveyed|convey
convoked|convoke
convoyed|convoy
convulsed|convulse
cooped|coop
coordinated|coordinate
copied|copy
copyrighted|copyright
corded|cord
cordoned|cordon
cored|core
corked|cork
cornered|corner
corralled|corral
corrected|correct
corroborated|corroborate
countenanced|countenance
counteracted|counteract
counterbalanced|counterbalance
counterfeited|counterfeit
countermanded|countermand
countersigned|countersign
coupled|couple
courted|court
court-martialed|court-martial
coveted|covet
cradled|cradle
cramped|cramp
craned|crane
crayoned|crayon
creamed|cream
created|create
credited|credit
cremated|cremate
crimped|crimp
crippled|cripple
criticized|criticize
cross-examined|cross-examine
cross-fertilized|cross-fertilize
cross-indexed|cross-index
cross-questioned|cross-question
crossbred|crossbreed
crowned|crown
crucified|crucify
crushed|crush
cubed|cube
cudgeled|cudgel
cuffed|cuff
culled|cull
cultivated|cultivate
cupped|cup
curbed|curb
cured|cure
curried|curry
curtailed|curtail
cushioned|cushion
damaged|damage
damned|damn
dampened|dampen
dandled|dandle
daubed|daub
daunted|daunt
dazed|daze
dazzled|dazzle
de-escalated|de-escalate
de-iced|de-ice
deadened|deaden
deafened|deafen
debarred|debar
debased|debase
debauched|debauch
debilitated|debilitate
debited|debit
debriefed|debrief
debugged|debug
debunked|debunk
decanted|decant
decapitated|decapitate
decarbonized|decarbonize
deceived|deceive
decentralized|decentralize
decertified|decertify
decimalized|decimalize
decimated|decimate
deciphered|decipher
decked|deck
declaimed|declaim
declassified|declassify
decoded|decode
decolonized|decolonize
decompressed|decompress
decontaminated|decontaminate
decorated|decorate
decried|decry
dedicated|dedicate
deducted|deduct
deep-frozen|deep-freeze
defaced|deface
defamed|defame
defeated|defeat
defended|defend
deferred|defer
defiled|defile
defined|define
deflated|deflate
deflowered|deflower
defoliated|defoliate
deforested|deforest
deformed|deform
defrauded|defraud
defrayed|defray
defrocked|defrock
defrosted|defrost
defused|defuse
defied|defy
degraded|degrade
dehumanized|dehumanize
dehydrated|dehydrate
deified|deify
delegated|delegate
deleted|delete
delimited|delimit
delineated|delineate
deluded|delude
demagnetized|demagnetize
demarcated|demarcate
demeaned|demean
demilitarized|demilitarize
demisted|demist
demobilized|demobilize
demolished|demolish
demoralized|demoralize
demoted|demote
denationalized|denationalize
denigrated|denigrate
denominated|denominate
denoted|denote
denounced|denounce
dented|dent
denuded|denude
deodorized|deodorize
depleted|deplete
deplored|deplore
deployed|deploy
depopulated|depopulate
deported|deport
deposed|depose
deposited|deposit
deprecated|deprecate
deprogrammed|deprogram
deranged|derange
derided|deride
desalinated|desalinate
desalinized|desalinize
desecrated|desecrate
desegregated|desegregate
desensitized|desensitize
deserted|desert
desiccated|desiccate
designated|designate
despatched|despatch
despised|despise
despoiled|despoil
destroyed|destroy
detached|detach
detained|detain
detected|detect
deterred|deter
detested|detest
dethroned|dethrone
devaluated|devaluate
devalued|devalue
devastated|devastate
devised|devise
devoted|devote
devoured|devour
diagnosed|diagnose
diced|dice
diddled|diddle
diffracted|diffract
dignified|dignify
diluted|dilute
directed|direct
disabled|disable
disallowed|disallow
disappointed|disappoint
disarranged|disarrange
disassociated|disassociate
disavowed|disavow
disbursed|disburse
discarded|discard
disciplined|discipline
disclaimed|disclaim
discomfited|discomfit
disconcerted|disconcert
disconnected|disconnect
discontented|discontent
discounted|discount
discouraged|discourage
discredited|discredit
disdained|disdain
disembarrassed|disembarrass
disembowelled|disembowel
disenchanted|disenchant
disenfranchised|disenfranchise
disestablished|disestablish
disfavoured|disfavour
disfigured|disfigure
disgorged|disgorge
disgraced|disgrace
disguised|disguise
disheartened|dishearten
dishonoured|dishonour
disillusioned|disillusion
disinfected|disinfect
disinherited|disinherit
disinterred|disinter
dislocated|dislocate
dislodged|dislodge
dismantled|dismantle
dismembered|dismember
dismissed|dismiss
disobeyed|disobey
disoriented|disorient
disorientated|disorientate
disowned|disown
disparaged|disparage
dispatched|dispatch
dispelled|dispel
displaced|displace
displayed|display
displeased|displease
dispossessed|dispossess
disproved|disprove
disqualified|disqualify
disregarded|disregard
disrupted|disrupt
dissected|dissect
disseminated|disseminate
dissociated|dissociate
dissuaded|dissuade
distanced|distance
distilled|distil
distorted|distort
distracted|distract
distributed|distribute
distrusted|distrust
disturbed|disturb
ditched|ditch
diverted|divert
divested|divest
divorced|divorce
divulged|divulge
dizzied|dizzy
doctored|doctor
documented|document
doffed|doff
domesticated|domesticate
dominated|dominate
donated|don
donned|donate
doomed|doom
doped|dope
dotted|dot
double-checked|double-check
double-crossed|double-cross
doused|douse
downed|down
downgraded|downgrade
downloaded|download
dragooned|dragoon
dramatized|dramatize
draped|drape
drenched|drench
drip-dried|drip-dry
drubbed|drub
drugged|drug
dry-cleaned|dry-clean
dumbfounded|dumbfound
dunked|dunk
duped|dupe
duplicated|duplicate
dusted|dust
dwarfed|dwarf
dyed|dye
dynamited|dynamite
earmarked|earmark
earned|earn
eclipsed|eclipse
edified|edify
edited|edit
effaced|efface
effected|effect
elbowed|elbow
electrified|electrify
electrocuted|electrocute
elevated|elevate
elicited|elicit
elided|elide
eliminated|eliminate
elucidated|elucidate
eluded|elude
emancipated|emancipate
emasculated|emasculate
embalmed|embalm
embargoed|embargo
embedded|embed
embellished|embellish
embezzled|embezzle
embittered|embitter
emblazoned|emblazon
embodied|embody
emboldened|embolden
embossed|emboss
embraced|embrace
embroiled|embroil
emended|emend
emitted|emit
empanelled|empanel
empowered|empower
emulated|emulate
emulsified|emulsify
enacted|enact
enamelled|enamel
encased|encase
enchanted|enchant
encircled|encircle
enclosed|enclose
encoded|encode
encompassed|encompass
encountered|encounter
encrypted|encrypt
encumbered|encumber
endangered|endanger
endeared|endear
endorsed|endorse
endowed|endow
enervated|enervate
enfolded|enfold
enforced|enforce
enfranchised|enfranchise
engendered|engender
engineered|engineer
engraved|engrave
engrossed|engross
engulfed|engulf
enhanced|enhance
enjoined|enjoin
enlarged|enlarge
enlightened|enlighten
enlivened|enliven
enmeshed|enmesh
ennobled|ennoble
enraged|enrage
enriched|enrich
ensconced|ensconce
enshrined|enshrine
enshrouded|enshroud
enslaved|enslave
ensnared|ensnare
entangled|entangle
enthralled|enthral
enthralled|enthrall
enthroned|enthrone
entombed|entomb
entrained|entrain
entranced|entrance
entrapped|entrap
entreated|entreat
entrusted|entrust
entwined|entwine
enumerated|enumerate
enveloped|envelop
envisaged|envisage
envied|envy
epitomized|epitomize
equalized|equal
equalled|equalize
equated|equate
equipped|equip
eradicated|eradicate
erased|erase
erected|erect
eschewed|eschew
escorted|escort
espoused|espouse
espied|espy
established|establish
esteemed|esteem
eulogized|eulogize
evaded|evade
evaluated|evaluate
evicted|evict
evinced|evince
eviscerated|eviscerate
evoked|evoke
exacerbated|exacerbate
exalted|exalt
examined|examine
exasperated|exasperate
excavated|excavate
exceeded|exceed
excepted|except
exchanged|exchange
excised|excise
excluded|exclude
excommunicated|excommunicate
excoriated|excoriate
excreted|excrete
exculpated|exculpate
excused|excuse
executed|execute
exemplified|exemplify
exempted|exempt
exerted|exert
exhausted|exhaust
exhibited|exhibit
exhilarated|exhilarate
exhumed|exhume
exiled|exile
exorcized|exorcize
expedited|expedite
expelled|expel
expended|expend
experienced|experience
expiated|expiate
explicated|explicate
exploited|exploit
exported|export
exposed|expose
expressed|express
expropriated|expropriate
expunged|expunge
expurgated|expurgate
extenuated|extenuate
exterminated|exterminate
externalized|externalize
extinguished|extinguish
extirpated|extirpate
extolled|extol
extorted|extort
extracted|extract
extradited|extradite
extricated|extricate
exuded|exude
eyed|eye
fabricated|fabricate
facilitated|facilitate
fagged|fag
faked|fake
falsified|falsify
familiarized|familiarize
fancied|fancy
fascinated|fascinate
fashioned|fashion
fated|fate
fathomed|fathom
fatigued|fatigue
faulted|fault
favoured|favour
feathered|feather
featured|feature
fed|feed
feigned|feign
felled|fell
fenced|fence
ferreted|ferret
fertilized|fertilize
festooned|festoon
feted|fete
fettered|fetter
filleted|fillet
finalized|finalize
financed|finance
fine-tuned|fine-tune
fingered|finger
flagellated|flagellate
flanked|flank
flattered|flatter
flaunted|flaunt
flavoured|flavour
flayed|flay
fleeced|fleece
flexed|flex
flicked|flick
flogged|flog
floodlit|floodlight
floored|floor
flouted|flout
fluffed|fluff
flummoxed|flummox
fluoridated|fluoridate
flurried|flurry
flustered|fluster
foiled|foil
foisted|foist
fomented|foment
fondled|fondle
fooled|fool
force-fed|force-feed
forded|ford
forecasted|forecast
foregone|forego
foreordained|foreordain
foreshadowed|foreshadow
foreshortened|foreshorten
forestalled|forestall
foresworn|foreswear
foretold|foretell
forfeited|forfeit
forged|forge
forgone|forgo
formalized|formalize
formulated|formulate
forsaken|forsake
forsworn|forswear
fortified|fortify
forwarded|forward
fostered|foster
founded|found
framed|frame
franked|frank
freed|free
frequented|frequent
frescoed|fresco
fricasseed|fricassee
frightened|frighten
frisked|frisk
frittered|fritter
frogmarched|frogmarch
frustrated|frustrate
fried|fry
fulfilled|fulfil
fulfilled|fulfill
fumigated|fumigate
funded|fund
funnelled|funnel
furbished|furbish
furnished|furnish
furrowed|furrow
furthered|further
gaged|gage
gainsaid|gainsay
galled|gall
galvanized|galvanize
gaoled|gaol
garbed|garb
garbled|garble
garnered|garner
garnished|garnish
garrisoned|garrison
gashed|gash
gatecrashed|gatecrash
gauged|gauge
generated|generate
gerrymandered|gerrymander
gilded|gild
ginned|gin
girded|gird
gladdened|gladden
glamorized|glamorize
gleaned|glean
glimpsed|glimpse
glorified|glorify
glutted|glut
goaded|goad
gored|gore
gorged|gorge
grabbed|grab
graced|grace
graded|grade
grafted|graft
gratified|gratify
gravelled|gravel
greased|grease
greeted|greet
grilled|grill
gripped|grip
gritted|grit
groined|groin
groomed|groom
grossed|gross
grudged|grudge
guarded|guard
guided|guide
guillotined|guillotine
gummed|gum
gunned|gun
gutted|gut
guzzled|guzzle
gypped|gyp
hallowed|hallow
halted|halt
halved|halve
hampered|hamper
hamstrung|hamstring
handcuffed|handcuff
handicapped|handicap
handled|handle
harangued|harangue
harassed|harass
harbored|harbor
harboured|harbour
harmed|harm
harnessed|harness
harpooned|harpoon
harrowed|harrow
harried|harry
harvested|harvest
hassled|hassle
haunted|haunt
hawked|hawk
hazarded|hazard
hazed|haze
heaped|heap
heartened|hearten
heeded|heed
heralded|herald
highjacked|highjack
highlighted|highlight
hijacked|hijack
hindered|hinder
hit|hit
hoaxed|hoax
hobbled|hobble
hocked|hock
hogged|hog
hollowed|hollow
homogenized|homogenize
honed|hone
honored|honor
honoured|honour
hooded|hood
hoodwinked|hoodwink
horrified|horrify
horsewhipped|horsewhip
hosed|hose
hospitalized|hospitalize
hosted|host
hotfooted|hotfoot
hounded|hound
housed|house
hulled|hull
humbled|humble
humbugged|humbug
humiliated|humiliate
humoured|humour
humped|hump
hunched|hunch
hurled|hurl
husked|husk
hyphenated|hyphenate
hypnotized|hypnotize
idealized|idealize
identified|identify
idolized|idolize
ignored|ignore
ill-treated|ill-treat
illuminated|illuminate
illumined|illumine
illustrated|illustrate
imaged|image
imbibed|imbibe
imbued|imbue
imitated|imitate
immersed|immerse
immobilized|immobilize
immolated|immolate
immortalized|immortalize
immunized|immunize
impacted|impact
impaired|impair
impaled|impale
impanelled|impanel
imparted|impart
impeached|impeach
impeded|impede
imperilled|imperil
impersonated|impersonate
implanted|implant
implemented|implement
implicated|implicate
imported|import
imposed|impose
impounded|impound
impoverished|impoverish
impregnated|impregnate
impressed|impress
imprinted|imprint
imprisoned|imprison
impugned|impugn
imputed|impute
inactivated|inactivate
inaugurated|inaugurate
incapacitated|incapacitate
incarcerated|incarcerate
incensed|incense
incinerated|incinerate
included|include
inconvenienced|inconvenience
incriminated|incriminate
inculcated|inculcate
incurred|incur
indemnified|indemnify
indentured|indenture
indexed|index
indicted|indict
individuated|individuate
indoctrinated|indoctrinate
inducted|induct
infatuated|infatuate
infected|infect
infested|infest
infiltrated|infiltrate
inflamed|inflame
inflated|inflate
inflected|inflect
inflicted|inflict
influenced|influence
infuriated|infuriate
infused|infuse
ingested|ingest
ingratiated|ingratiate
inhabited|inhabit
inherited|inherit
inhibited|inhibit
initialled|initial
initiated|initiate
injected|inject
injured|injure
inked|ink
inoculated|inoculate
inscribed|inscribe
inseminated|inseminate
inserted|insert
inspected|inspect
installed|install
instigated|instigate
instilled|instil
instilled|instill
instituted|institute
institutionalized|institutionalize
insulated|insulate
insulted|insult
insured|insure
integrated|integrate
interred|inter
intercepted|intercept
interchanged|interchange
interdicted|interdict
interested|interest
interjected|interject
interleaved|interleave
internalized|internalize
internationalized|internationalize
interpolated|interpolate
interrogated|interrogate
interspersed|intersperse
interwoven|interweave
intimidated|intimidate
intoned|intone
intoxicated|intoxicate
introduced|introduce
intuited|intuit
inundated|inundate
invaded|invade
invalidated|invalidate
inveigled|inveigle
invented|invent
inverted|invert
invigorated|invigorate
invoked|invoke
irked|irk
irradiated|irradiate
irrigated|irrigate
isolated|isolate
italicized|italicize
itemized|itemize
iterated|iterate
jailed|jail
jarred|jar
jeopardized|jeopardize
jettisoned|jettison
jilted|jilt
jollied|jolly
jugged|jug
juxtaposed|juxtapose
kenned|ken
kidnapped|kidnap
kissed|kiss
kneaded|knead
knifed|knife
knighted|knight
labelled|label
laced|lace
lacerated|lacerate
lacked|lack
lacquered|lacquer
lambasted|lambaste
laminated|laminate
lampooned|lampoon
lanced|lance
landscaped|landscape
lassoed|lasso
lauded|laud
laundered|launder
lavished|lavish
leached|leach
leapfrogged|leapfrog
leased|lease
leavened|leaven
legalized|legalize
legitimatized|legitimatize
levered|lever
leveraged|leverage
levied|levy
libelled|libel
liberalized|liberalize
liberated|liberate
licenced|licence
likened|liken
limited|limit
lionized|lionize
liquidized|liquidize
listed|list
loaned|loan
loathed|loathe
lobbed|lob
localized|localize
lofted|loft
looted|loot
lubricated|lubricate
lugged|lug
lulled|lull
lumped|lump
lured|lure
lynched|lynch
maddened|madden
magnetized|magnetize
magnified|magnify
maimed|maim
maligned|malign
maltreated|maltreat
manned|man
manacled|manacle
mandated|mandate
mangled|mangle
manhandled|manhandle
manicured|manicure
manifested|manifest
manipulated|manipulate
manufactured|manufacture
marred|mar
marketed|market
marooned|maroon
marshalled|marshal
martyred|martyr
mashed|mash
masked|mask
mass-produced|mass-produce
massaged|massage
mastered|master
masterminded|mastermind
masticated|masticate
mauled|maul
maximized|maximize
measured|measure
mechanized|mechanize
medicated|medicate
memorialized|memorialize
memorized|memorize
menaced|menace
merited|merit
mesmerized|mesmerize
microfilmed|microfilm
milked|milk
mimeographed|mimeograph
mimicked|mimic
minced|mince
miniaturized|miniaturize
minimized|minimize
minted|mint
mired|mire
mirrored|mirror
misapplied|misapply
misapprehended|misapprehend
misappropriated|misappropriate
miscast|miscast
misconceived|misconceive
misconstrued|misconstrue
misdated|misdate
misdirected|misdirect
misgoverned|misgovern
misguided|misguide
mishandled|mishandle
misheard|mishear
misinformed|misinform
misinterpreted|misinterpret
mislaid|mislay
misled|mislead
mismanaged|mismanage
misnamed|misname
misplaced|misplace
mispronounced|mispronounce
misquoted|misquote
misread|misread
misrepresented|misrepresent
misspelled|misspell
misspent|misspend
misstated|misstate
mistaken|mistake
mistranslated|mistranslate
mistreated|mistreat
mistrusted|mistrust
misused|misuse
mitigated|mitigate
mobbed|mob
mocked|mock
modeled|model
modified|modify
modulated|modulate
molded|mold
molested|molest
mollified|mollify
mollycoddled|mollycoddle
monitored|monitor
monopolized|monopolize
moored|moor
mortared|mortar
mortgaged|mortgage
mortified|mortify
mothproofed|mothproof
motorized|motorize
muddied|muddy
muffed|muff
muffled|muffle
mugged|mug
mulched|mulch
murdered|murder
mustered|muster
muted|mute
mutilated|mutilate
muzzled|muzzle
mystified|mystify
nabbed|nab
nagged|nag
narrated|narrate
nationalized|nationalize
naturalized|naturalize
needled|needle
negated|negate
netted|net
nettled|nettle
neutered|neuter
neutralized|neutralize
nicked|nick
nicknamed|nickname
normalized|normalize
nourished|nourish
nudged|nudge
nullified|nullify
numbed|numb
numbered|number
nursed|nurse
nurtured|nurture
obfuscated|obfuscate
obligated|obligate
obliterated|obliterate
obscured|obscure
obstructed|obstruct
obtained|obtain
obviated|obviate
occasioned|occasion
occupied|occupy
offended|offend
offset|offset
oiled|oil
okayed|okay
omened|omen
omitted|omit
oppressed|oppress
orchestrated|orchestrate
ordained|ordain
organized|organize
oriented|orient
orientated|orientate
ornamented|ornament
ostracized|ostracize
ousted|oust
outbalanced|outbalance
outbid|outbid
outclassed|outclass
outdistanced|outdistance
outdone|outdo
outfought|outfight
outfitted|outfit
outflanked|outflank
outfoxed|outfox
outgrown|outgrow
outlasted|outlast
outlawed|outlaw
outlined|outline
outlived|outlive
outmanoeuvred|outmanoeuvre
outnumbered|outnumber
outplayed|outplay
outraged|outrage
outranked|outrank
outridden|outride
outrun|outrun
outshone|outshine
outsmarted|outsmart
outstayed|outstay
outvoted|outvote
outweighed|outweigh
outwitted|outwit
overawed|overawe
overbore|overbear
overburdened|overburden
overcooked|overcook
overcome|overcome
overcrowded|overcrowd
overdone|overdo
overemphasized|overemphasize
overestimated|overestimate
overexerted|overexert
overexposed|overexpose
overhauled|overhaul
overheard|overhear
overleaped|overleap
overloaded|overload
overlooked|overlook
overpaid|overpay
overplayed|overplay
overpowered|overpower
overpraised|overpraise
overprinted|overprint
overrated|overrate
overriden|override
overruled|overrule
overrun|overrun
overseen|oversee
overshadowed|overshadow
overshot|overshoot
oversimplified|oversimplify
overstated|overstate
overstayed|overstay
overstepped|overstep
overstocked|overstock
overstrained|overstrain
overtaken|overtake
overtaxed|overtax
overvalued|overvalue
overwhelmed|overwhelm
owned|own
oxygenated|oxygenate
pacified|pacify
packaged|package
padded|pad
padlocked|padlock
paged|page
pained|pain
pampered|pamper
papered|paper
parallelled|parallel
paralysed|paralyse
paralyzed|paralyze
paraphrased|paraphrase
parched|parch
pardoned|pardon
pared|pare
parodied|parody
paroled|parole
parried|parry
parsed|parse
partitioned|partition
partnered|partner
pasted|paste
pasteurized|pasteurize
patted|pat
patented|patent
patrolled|patrol
patronized|patronize
patterned|pattern
pauperized|pauperize
pawed|paw
pawned|pawn
pegged|peg
pelted|pelt
penalized|penalize
pencilled|pencil
peppered|pepper
perfected|perfect
perforated|perforate
perfumed|perfume
perfused|perfuse
perjured|perjure
permed|perm
permeated|permeate
permuted|permute
perpetrated|perpetrate
perpetuated|perpetuate
perplexed|perplex
persecuted|persecute
personalized|personalize
personified|personify
perturbed|perturb
perused|peruse
pervaded|pervade
perverted|pervert
pestered|pester
petted|pet
photocopied|photocopy
photographed|photograph
photosensitized|photosensitize
photostatted|photostat
phrased|phrase
pickled|pickle
pictured|picture
pierced|pierce
pigeonholed|pigeonhole
pilfered|pilfer
piloted|pilot
pinched|pinch
pinpointed|pinpoint
piped|pip
pipped|pipe
piqued|pique
pirated|pirate
pitted|pit
pitchforked|pitchfork
pitied|pity
placated|placate
placed|place
plagiarized|plagiarize
plagued|plague
planted|plant
plastered|plaster
pleased|please
plied|ply
plumbed|plumb
pocketed|pocket
poisoned|poison
polarized|polarize
policed|police
polished|polish
politicized|politicize
pollinated|pollinate
polluted|pollute
pondered|ponder
pooh-poohed|pooh-pooh
pooled|pool
popularized|popularize
populated|populate
ported|port
portended|portend
positioned|position
possessed|possess
posted|post
postdated|postdate
postmarked|postmark
postponed|postpone
powdered|powder
praised|praise
pre-empted|pre-empt
prearranged|prearrange
preceded|precede
precipitated|precipitate
precluded|preclude
preconceived|preconceive
predestined|predestine
predetermined|predetermine
predicated|predicate
predisposed|predispose
preempted|preempt
preened|preen
prefabricated|prefabricate
prefaced|preface
prefigured|prefigure
preheated|preheat
prejudged|prejudge
prejudiced|prejudice
premeditated|premeditate
premised|premise
preoccupied|preoccupy
preordained|preordain
prepaid|prepay
prerecorded|prerecord
presaged|presage
prescribed|prescribe
presented|present
preserved|preserve
presorted|presort
pressurized|pressurize
prettified|prettify
prevented|prevent
priced|price
prided|pride
primed|prime
printed|print
privileged|privilege
prized|prize
probed|probe
processed|process
procured|procure
prodded|prod
produced|produce
proffered|proffer
profiled|profile
prognosticated|prognosticate
prohibited|prohibit
projected|project
prolonged|prolong
promoted|promote
promulgated|promulgate
pronounced|pronounce
proofed|proof
propelled|propel
proportioned|proportion
propositioned|proposition
propounded|propound
proscribed|proscribe
prosecuted|prosecute
prostituted|prostitute
prostrated|prostrate
protected|protect
pruned|prune
psychoanalysed|psychoanalyse
psychoanalyzed|psychoanalyze
publicized|publicize
published|publish
pulverized|pulverize
pummelled|pummel
punctuated|punctuate
punished|punish
purchased|purchase
purified|purify
purloined|purloin
pursed|purse
pursued|pursue
purveyed|purvey
quaffed|quaff
qualified|qualify
quantified|quantify
quarantined|quarantine
quartered|quarter
quashed|quash
quelled|quell
quenched|quench
queried|query
questioned|question
quick-frozen|quick-freeze
quilted|quilt
quoted|quote
raffled|raffle
raided|raid
railroaded|railroad
rammed|ram
ramped|ramp
ransacked|ransack
ransomed|ransom
raped|rape
ratified|ratify
rationed|ration
rationalized|rationalize
ravaged|ravage
ravished|ravish
razed|raze
re-addressed|re-address
re-educated|re-educate
re-established|re-establish
readmitted|readmit
reaped|reap
rearranged|rearrange
reassessed|reassess
reauthorized|reauthorize
rebuffed|rebuff
rebuked|rebuke
rebutted|rebut
recaptured|recapture
recast|recast
recessed|recess
recited|recite
reclaimed|reclaim
recommitted|recommit
recompensed|recompense
reconciled|reconcile
reconditioned|recondition
reconsecrated|reconsecrate
reconsidered|reconsider
reconstructed|reconstruct
reconvicted|reconvict
recouped|recoup
recreated|recreate
rectified|rectify
recycled|recycle
redecorated|redecorate
redeemed|redeem
redefined|redefine
redeployed|redeploy
redesigned|redesign
redeveloped|redevelop
rediscovered|rediscover
redistributed|redistribute
redone|redo
redressed|redress
reduced|reduce
reduplicated|reduplicate
reestablished|reestablish
refashioned|refashion
refilled|refill
refinanced|refinance
refined|refine
reformulated|reformulate
refracted|refract
refreshed|refresh
refrigerated|refrigerate
refunded|refund
refurbished|refurbish
refurnished|refurnish
refuted|refute
regained|regain
regaled|regale
regimented|regiment
regularized|regularize
regulated|regulate
regurgitated|regurgitate
rehabilitated|rehabilitate
rehashed|rehash
rehoused|rehouse
reimbursed|reimburse
reinforced|reinforce
reinstated|reinstate
reinsured|reinsure
reintegrated|reintegrate
reinterpreted|reinterpret
reinvented|reinvent
reissued|reissue
rejected|reject
rejoined|rejoin
rejuvenated|rejuvenate
relayed|relay
released|release
relegated|relegate
relieved|relieve
relinquished|relinquish
relished|relish
relisted|relist
relived|relive
remanded|remand
remedied|remedy
remilitarized|remilitarize
remodelled|remodel
remoulded|remould
removed|remove
remunerated|remunerate
rent|rend
renewed|renew
renounced|renounce
renovated|renovate
reoriented|reorient
reorientated|reorientate
repackaged|repackage
repainted|repaint
repatriated|repatriate
repealed|repeal
repelled|repel
replaced|replace
replanted|replant
replayed|replay
replenished|replenish
replicated|replicate
reprehended|reprehend
represented|represent
repressed|repress
reprieved|reprieve
reprimanded|reprimand
reprinted|reprint
reproached|reproach
reproofed|reproof
reproved|reprove
repudiated|repudiate
repulsed|repulse
repurchased|repurchase
reputed|repute
requisitioned|requisition
reread|reread
rerouted|reroute
rescheduled|reschedule
rescinded|rescind
rescued|rescue
researched|research
reseated|reseat
resold|resell
resembled|resemble
resented|resent
reserved|reserve
reset|reset
reshaped|reshape
reshuffled|reshuffle
resoled|resole
respected|respect
restated|restate
restocked|restock
restored|restore
restrained|restrain
restricted|restrict
restructured|restructure
resumed|resume
resurrected|resurrect
retained|retain
retaken|retake
retarded|retard
retold|retell
rethought|rethink
retouched|retouch
retraced|retrace
retracted|retract
retransmitted|retransmit
retrieved|retrieve
revalued|revalue
revamped|revamp
revered|revere
reviewed|review
reviled|revile
revised|revise
revisited|revisit
revitalized|revitalize
revoked|revoke
revolutionized|revolutionize
rewarded|reward
rewired|rewire
reworded|reword
rewritten|rewrite
ribbed|rib
riddled|riddle
ridiculed|ridicule
rifled|rifle
righted|right
rimmed|rim
rivaled|rival
rivalled|rival
riveted|rivet
romanticized|romanticize
roped|rope
routed|rout
routed|route
rubber-stamped|rubber-stamp
rubberized|rubberize
rued|rue
ruined|ruin
rumpled|rumple
rusticated|rusticate
sabotaged|sabotage
sacked|sack
saddened|sadden
saddled|saddle
safeguarded|safeguard
salted|salt
salvaged|salvage
sampled|sample
sanctified|sanctify
sanctioned|sanction
sanded|sand
sandblasted|sandblast
sandpapered|sandpaper
sandwiched|sandwich
sapped|sap
satiated|satiate
satirized|satirize
satisfied|satisfy
saturated|saturate
sauteed|saute
savaged|savage
savoured|savour
scalded|scald
scalped|scalp
scandalized|scandalize
scanted|scant
scarred|scar
scented|scent
scheduled|schedule
schooled|school
scooped|scoop
scorched|scorch
scorned|scorn
scotched|scotch
scoured|scour
scrapped|scrap
screened|screen
scrunched|scrunch
scrutinized|scrutinize
sculpted|sculpt
scuttled|scuttle
seared|sear
seasoned|season
seated|seat
seconded|second
secreted|secrete
secularized|secularize
secured|secure
sedated|sedate
seduced|seduce
seeded|seed
segregated|segregate
selected|select
sensitized|sensitize
sentimentalized|sentimentalize
sequestered|sequester
serenaded|serenade
serialized|serialize
serviced|service
shackled|shackle
shadowed|shadow
shamed|shame
shampooed|shampoo
shared|share
sharpened|sharpen
sheared|shear
sheathed|sheathe
sheltered|shelter
shed|shed
shelved|shelve
shepherded|shepherd
shielded|shield
shingled|shingle
shirked|shirk
shocked|shock
shooed|shoo
short-changed|short-change
shortlisted|shortlist
shouldered|shoulder
shovelled|shovel
shredded|shred
shrouded|shroud
shucked|shuck
shunned|shun
shunted|shunt
shuttered|shutter
sicked|sick
sickened|sicken
sidelined|sideline
sidestepped|sidestep
sidetracked|sidetrack
sieved|sieve
sighted|sight
signposted|signpost
silenced|silence
silhouetted|silhouette
simplified|simplify
simulated|simulate
siphoned|siphon
sired|sire
skewered|skewer
skinned|skin
skippered|skipper
skirted|skirt
slaked|slake
slandered|slander
slapped|slap
slashed|slash
slated|slate
slaughtered|slaughter
slain|slay
sliced|slice
slighted|slight
slung|sling
slotted|slot
slugged|slug
slurred|slur
smelted|smelt
smitten|smite
smothered|smother
snagged|snag
snared|snare
snubbed|snub
socked|sock
soft-pedalled|soft-pedal
soiled|soil
soldered|solder
solicited|solicit
solved|solve
soothed|soothe
soundproofed|soundproof
souped|soup
soused|souse
spaded|spade
spanned|span
spanked|spank
spared|spare
spayed|spay
speared|spear
spearheaded|spearhead
specified|specify
spewed|spew
spiked|spike
spin-dried|spin-dry
spirited|spirit
spited|spite
spliced|splice
sponsored|sponsor
spoonfed|spoonfeed
spotted|spot
spotlighted|spotlight
sprained|sprain
sprayed|spray
sprinkled|sprinkle
spurned|spurn
squandered|squander
squelched|squelch
squired|squire
stabbed|stab
staffed|staff
staged|stage
stalemated|stalemate
standardized|standardize
stapled|staple
starched|starch
startled|startle
stashed|stash
stationed|station
staunched|staunch
stolen|steal
steamrollered|steamroller
steeled|steel
stereotyped|stereotype
sterilized|sterilize
stiffed|stiff
stigmatized|stigmatize
stilled|still
stimulated|stimulate
stitched|stitch
stockaded|stockade
stoked|stoke
stomached|stomach
stoned|stone
stored|store
stowed|stow
straddled|straddle
strafed|strafe
straitened|straiten
strangled|strangle
strapped|strap
streamlined|streamline
strewed|strew
stroked|stroke
structured|structure
stubbed|stub
stuccoed|stucco
studded|stud
stunned|stun
stunted|stunt
styled|style
stylized|stylize
stymied|stymie
subdued|subdue
subedited|subedit
subjected|subject
subjugated|subjugate
sublimated|sublimate
subordinated|subordinate
subpoenaed|subpoena
subserved|subserve
subsidized|subsidize
substantiated|substantiate
subsumed|subsume
subtended|subtend
subtracted|subtract
subverted|subvert
succoured|succour
suckled|suckle
suffused|suffuse
suited|suit
sullied|sully
summarized|summarize
summoned|summon
sunned|sun
sundered|sunder
superimposed|superimpose
superseded|supersede
supplanted|supplant
supplemented|supplement
supplied|supply
supported|support
suppressed|suppress
surmounted|surmount
surpassed|surpass
surrounded|surround
surveyed|survey
suspended|suspend
sustained|sustain
swamped|swamp
swathed|swat
swatted|swathe
sweetened|sweeten
swigged|swig
swindled|swindle
swiped|swipe
symbolized|symbolize
syncopated|syncopate
syndicated|syndicate
synthesized|synthesize
syphoned|syphon
systematized|systematize
tabled|table
tabulated|tabulate
tailed|tail
tailored|tailor
tainted|taint
tamed|tame
tamped|tamp
tantalized|tantalize
tarred|tar
targeted|target
tattooed|tattoo
taunted|taunt
taxed|tax
teased|tease
telecast|telecast
telescoped|telescope
televised|televise
tendered|tender
terraced|terrace
terrified|terrify
terrorized|terrorize
tested|test
test-driven|test-drive
tethered|tether
thanked|thank
thatched|thatch
thirsted|thirst
threaded|thread
thumbed|thumb
thwarted|thwart
ticketed|ticket
tiled|tile
tilled|till
timed|time
tinted|tint
titillated|titillate
toed|toe
tolerated|tolerate
tormented|torment
torpedoed|torpedo
tortured|torture
toted|tote
toured|tour
tousled|tousle
touted|tout
towed|tow
towelled|towel
trampled|trample
tranquilized|tranquilize
tranquillized|tranquillize
transacted|transact
transcended|transcend
transcribed|transcribe
transfixed|transfix
transformed|transform
transfused|transfuse
transmitted|transmit
transmuted|transmute
transported|transport
transposed|transpose
transshipped|transship
trapped|trap
traversed|traverse
treasured|treasure
tricked|trick
triggered|trigger
trivialized|trivialize
troubled|trouble
trounced|trounce
truncated|truncate
tutored|tutor
tweaked|tweak
twiddled|twiddle
typecast|typecast
typified|typify
tyrannized|tyrannize
unbalanced|unbalance
unbanned|unban
unblocked|unblock
unbolted|unbolt
unbuckled|unbuckle
unburdened|unburden
unbuttoned|unbutton
uncorked|uncork
uncoupled|uncouple
uncovered|uncover
uncrossed|uncross
undercharged|undercharge
undercut|undercut
underestimated|underestimate
underexposed|underexpose
undergone|undergo
underlay|underlie
underlined|underline
undermined|undermine
underpaid|underpay
underpinned|underpin
underquoted|underquote
underrated|underrate
underscored|underscore
undersold|undersell
undershot|undershoot
undersigned|undersign
understated|understate
understocked|understock
understudied|understudy
undervalued|undervalue
underwritten|underwrite
undone|undo
unearthed|unearth
unfettered|unfetter
unfrocked|unfrock
unfurled|unfurl
unhanded|unhand
unhinged|unhinge
unhooked|unhook
unlearned|unlearn
unleashed|unleash
unloosed|unloose
unmasked|unmask
unnerved|unnerve
unplugged|unplug
unsaddled|unsaddle
unscrambled|unscramble
unsettled|unsettle
unsheathed|unsheathe
unveiled|unveil
unzipped|unzip
upbraided|upbraid
updated|update
upgraded|upgrade
upheld|uphold
upholstered|upholster
uplifted|uplift
uprooted|uproot
upset|upset
upstaged|upstage
ushered|usher
usurped|usurp
utilized|utilize
uttered|utter
vacated|vacate
vaccinated|vaccinate
valeted|valet
validated|validate
valued|value
vanquished|vanquish
varnished|varnish
veiled|veil
vended|vend
venerated|venerate
vented|vent
ventilated|ventilate
verbalized|verbalize
vetoed|vet
vetted|veto
vexed|vex
victimized|victimize
videotaped|videotape
vilified|vilify
vindicated|vindicate
violated|violate
visaed|visa
visualized|visualize
vitiated|vitiate
vivisected|vivisect
vocalized|vocalize
voiced|voice
voided|void
vouchsafed|vouchsafe
vulgarized|vulgarize
waged|wage
waived|waive
walled|wall
walloped|wallop
wangled|wangle
warded|ward
warranted|warrant
wasted|waste
waterproofed|waterproof
waylaid|waylay
weaned|wean
weathered|weather
wedged|wedge
weighted|weight
welcomed|welcome
wended|wend
westernized|westernize
wetted|wet
whacked|whack
wheedled|wheedle
whetted|whet
whiled|while
whitewashed|whitewash
wielded|wield
winged|wing
winnowed|winnow
withheld|withhold
withstood|withstand
witnessed|witness
wolfed|wolf
wooed|woo
worded|word
wormed|worm
wounded|wound
wreaked|wreak
wrecked|wreck
wrenched|wrench
wrested|wrest
wronged|wrong
zapped|zap
zoned|zone
barged|barge
boozed|booze
bottomed|bottom
bowed|bow
branched|branch
breezed|breeze
brimmed|brim
bulged|bulge
caved|cave
clammed|clam
clicked|click
clowned|clown
come|come
crapped|crap
crawled|crawl
crept|creep
cropped|crop
crouched|crouch
cruised|cruise
cried|cry
danced|dance
darted|dart
dived|dive
dozed|doze
drifted|drift
droned|drone
faded|fade
fizzled|fizzle
flocked|flock
flowed|flow
foamed|foam
forked|fork
ganged|gang
geared|gear
goofed|goof
gushed|gush
hurried|hurry
jogged|jog
jutted|jut
keeled|keel
kneeled|kneel
knelt|kneel
knuckled|knuckle
lied|lie
limped|limp
lingered|linger
listened|listen
loomed|loom
lunged|lunge
lurched|lurch
marched|march
mellowed|mellow
nestled|nestle
opted|opt
peeked|peek
peered|peer
perked|perk
petered|peter
pigged|pig
pined|pine
plonked|plonk
plopped|plop
puffed|puff
rotted|rot
sailed|sail
sallied|sally
sat|sit
screamed|scream
scurried|scurry
seeped|seep
shacked|shack
shined|shine
shone|shine
shopped|shop
shriveled|shrivel
shied|shy
slacked|slack
slaved|slave
slid|slide
slimmed|slim
slinked|slink
sloped|slope
slumped|slump
soared|soar
soldiered|soldier
spurted|spurt
squatted|squat
stood|stand
stepped|step
stooped|stoop
streamed|stream
strolled|stroll
strutted|strut
stumbled|stumble
swum|swim
swooped|swoop
teamed|team
tensed|tense
toddled|toddle
tramped|tramp
trickled|trickle
trudged|trudge
tumbled|tumble
veered|veer
wafted|waft
walked|walk
zeroed|zero
zoomed|zoom
skidded|skid
averaged|average
backed|back
bailed|bail
banged|bang
beamed|beam
beat|beat
beefed|beef
bellowed|bellow
bent|bend
bound|bind
blared|blare
bobbed|bob
bogged|bog
boiled|boil
bolted|bolt
bored|bore
bounced|bounce
bounded|bound
bowled|bowl
boxed|box
broken|break
breathed|breathe
brightened|brighten
bruised|bruise
brushed|brush
bucked|buck
buckled|buckle
built|build
bummed|bum
bumped|bump
bunched|bunch
burned|burn
busted|bust
butted|butt
buttoned|button
buzzed|buzz
calmed|calm
camped|camp
canceled|cancel
carved|carve
cashed|cash
cast|cast
caught|catch
changed|change
chatted|chat
cheated|cheat
checked|check
cheered|cheer
chewed|chew
chilled|chill
chipped|chip
choked|choke
chopped|chop
churned|churn
climbed|climb
clogged|clog
closed|close
clouded|cloud
clumped|clump
coiled|coil
combed|comb
connected|connect
contracted|contract
cooked|cook
cooled|cool
copped|cop
coughed|cough
counted|count
cracked|crack
crammed|cram
crossed|cross
crowded|crowd
crumbled|crumble
crumpled|crumple
crunched|crunch
curled|curl
dashed|dash
dealed|dealing
dialed|dial
dug|dig
dined|dine
dragged|drag
drained|drain
drawn|draw
dressed|dress
driven|drive
dropped|drop
drowned|drown
drummed|drum
dried|dry
ducked|duck
eased|ease
eaten|eat
edged|edge
emptied|empty
evened|even
faced|face
fanned|fan
farmed|farm
fattened|fatten
fended|fend
fetched|fetch
filed|file
filled|fill
filtered|filter
fired|fire
firmed|firm
fished|fish
flared|flare
flattened|flatten
flipped|flip
floated|float
flooded|flood
flunked|flunk
flushed|flush
flown|fly
folded|fold
followed|follow
fouled|foul
freaked|freak
frozen|freeze
freshened|freshen
fucked|fuck
fueled|fuel
galloped|gallop
gathered|gather
glazed|glaze
gobbled|gobble
grinded|grind
gulped|gulp
hacked|hack
hammered|hammer
hanged|hang
hung|hang
hauled|haul
headed|head
healed|heal
heated|heat
herded|herd
hidden|hide
hiked|hike
hitched|hitch
hooked|hook
hopped|hop
hunted|hunt
ironed|iron
jammed|jam
jerked|jerk
joined|join
jumbled|jumble
jumped|jump
knocked|knock
knotted|knot
lapped|lap
lashed|lash
led|lead
leaked|leak
leaned|lean
leaped|leap
leapt|leap
leveled|level
licked|lick
lit|light
lightened|lighten
limbered|limber
lined|line
livened|liven
logged|log
loosened|loosen
lost|lose
married|marry
matched|match
melted|melt
messed|mess
missed|miss
mopped|mop
mouthed|mouth
moved|move
mucked|muck
nodded|nod
oozed|ooze
opened|open
packed|pack
paired|pair
panned|pan
peeled|peel
piled|pile
pissed|piss
played|play
ploughed|plough
plowed|plow
plucked|pluck
plunged|plunge
pointed|point
poked|poke
popped|pop
pounded|pound
poured|pour
pried|pry
puckered|pucker
pulled|pull
pumped|pump
quieted|quiet
raked|rake
reached|reach
reeled|reel
rented|rent
revved|rev
ridden|ride
ringed|ring
rung|ring
ripped|rip
rocked|rock
rolled|roll
rooted|root
rounded|round
rubbed|rub
run|run
rushed|rush
scouted|scout
scraped|scrape
scratched|scratch
screwed|screw
sealed|seal
served|serve
settled|settle
sewed|sew
shaped|shape
shaved|shave
shifted|shift
shipped|ship
shot|shoot
shorted|short
shrugged|shrug
shushed|shush
signed|sign
shut|shut
sketched|sketch
skipped|skip
slipped|slip
slowed|slow
smartened|smarten
smashed|smash
smoothed|smooth
snapped|snap
snatched|snatch
sneaked|sneak
sniffed|sniff
snuffed|snuff
soaked|soak
sobered|sober
softened|soften
spaced|space
sparked|spark
sped|speed
speeded|speed
spelled|spell
spelt|spell
spilled|spill
spun|spin
spat|spit
split|split
spread|spread
sprung|spring
sprouted|sprout
spruced|spruce
squared|square
squeezed|squeeze
squirted|squirt
staggered|stagger
stamped|stamp
starred|star
starved|starve
steamed|steam
stuck|stick
stiffened|stiffen
stirred|stir
stocked|stock
stormed|storm
straightened|straighten
stretched|stretch
struck|strike
stripped|strip
sucked|suck
summed|sum
swelled|swell
swung|swing
switched|switch
tallied|tally
tangled|tangle
tapered|taper
thickened|thicken
thinned|thin
ticked|tick
tidied|tidy
tightened|tighten
tipped|tip
tired|tire
toned|tone
toppled|topple
tossed|toss
trailed|trail
treaded|tread
trimmed|trim
tripped|trip
tucked|tuck
tuned|tune
twisted|twist
typed|type
waken|wake
warmed|warm
weaved|weave
weeded|weed
weighed|weigh
whipped|whip
whooped|whoop
won|win
wound|wind
wiped|wipe
worked|work
wrapped|wrap
auctioned|auction
bandied|bandy
barred|bar
battened|batten
bitten|bite
blocked|block
blotted|blot
blown|blow
blurted|blurt
boarded|board
booked|book
booted|boot
bottled|bottle
bundled|bundle
buttered|butter
caged|cage
carried|carry
carted|cart
chalked|chalk
chased|chase
chucked|chuck
cleaned|clean
cluttered|clutter
covered|cover
cranked|crank
cut|cut
dammed|dam
dished|dish
divided|divide
doled|dole
dredged|dredge
drunk|drink
dumped|dump
egged|egg
eked|eke
factored|factor
faxed|fax
flinged|fling
flung|fling
fixed|fix
fobbed|fob
gouged|gouge
hammed|ham
hashed|hash
hoisted|hoist
jacked|jack
jazzed|jazz
jotted|jot
kicked|kick
killed|kill
laid|lay
lifted|lift
linked|link
loaded|load
locked|lock
lopped|lop
mailed|mail
mapped|map
marked|mark
meted|mete
mixed|mix
mulled|mull
mussed|muss
nailed|nail
palmed|palm
patched|patch
paved|pave
penned|pen
phased|phase
phoned|phone
picked|pick
pieced|piece
pinned|pin
plugged|plug
pricked|prick
propped|prop
punched|punch
pushed|push
racked|rack
reined|rein
rigged|rig
riled|rile
rinsed|rinse
roughed|rough
roughened|roughen
saved|save
scaled|scale
scared|scare
shaken|shake
shored|shore
singled|single
sized|size
skimmed|skim
smuggled|smuggle
sopped|sop
sorted|sort
spiced|spice
stacked|stack
staked|stake
staved|stave
stringed|string
strung|string
stuffed|stuff
sussed|suss
swept|sweep
tacked|tack
taped|tape
torn|tear
thrown|throw
tided|tide
tied|tie
topped|top
totaled|total
touched|touch
toughened|toughen
tracked|track
wadded|wad
washed|wash
worn|wear
wrung|wring
yanked|yank
zipped|zip
acknowledged|acknowledge
added|add
admitted|admit
affirmed|affirm
agreed|agree
announced|announce
argued|argue
ascertained|ascertain
asserted|assert
assumed|assume
believed|believe
bragged|brag
calculated|calculate
charged|charge
claimed|claim
commanded|command
commented|comment
complained|complain
conceded|concede
concluded|conclude
confessed|confess
confirmed|confirm
contended|contend
decided|decide
declared|declare
deduced|deduce
determined|determine
discerned|discern
disclosed|disclose
discovered|discover
emphasized|emphasize
envisioned|envision
exclaimed|exclaim
explained|explain
figured|figure
guessed|guess
hinted|hint
hoped|hope
implied|imply
inquired|inquire
insisted|insist
intimated|intimate
learned|learn
maintained|maintain
mused|muse
muttered|mutter
noted|note
observed|observe
ordered|order
pledged|pledge
postulated|postulate
predicted|predict
presumed|presume
proclaimed|proclaim
promised|promise
proposed|propose
proved|prove
read|read
realized|realize
reasoned|reason
recalled|recall
reckoned|reckon
recognized|recognize
recounted|recount
reflected|reflect
remarked|remark
remembered|remember
repeated|repeat
replied|reply
reported|report
resolved|resolve
responded|respond
retorted|retort
revealed|reveal
ruled|rule
shouted|shout
sighed|sigh
speculated|speculate
stated|state
stipulated|stipulate
stressed|stress
suggested|suggest
testified|testify
theorized|theorize
thought|think
threatened|threaten
warned|warn
whispered|whisper
wondered|wonder
written|write
related|relate
continued|continue