doing|do
having|have
being|be
arising|arise
coming|come
lying|lie
swimming|swim
shrinking|shrink
singing|sing
withdrawing|withdraw
sinking|sink
sinking|sink
forgiving|forgive
bidding|bid
hurting|hurt
thrusting|thrust
broadcasting|broadcast
rising|rise
falling|fall
splitting|split
spreading|spread
fitting|fit
shutting|shut
casting|cast
eating|eat
breaking|break
flying|fly
driving|drive
waking|wake
beating|beat
riding|ride
ringing|ring
hiding|hide
striking|strike
striking|strike
freezing|freeze
drawing|draw
springing|spring
running|run
hitting|hit
misreading|misread
shedding|shed
ridding|rid
overcoming|overcome
offsetting|offset
overrunning|overrun
upsetting|upset
undercutting|undercut
forsaking|forsake
overriding|override
overtaking|overtake
rewriting|rewrite
undoing|undo
besetting|beset
mistaking|mistake
underwriting|underwrite
biting|bite
throwing|throw
stealing|steal
shaking|shake
wearing|wear
blowing|blow
tearing|tear
cutting|cut
raising|raise
lowering|lower
consenting|consent
hesitating|hesitate
proceeding|proceed
aspiring|aspire
purporting|purport
endeavouring|endeavour
condescending|condescend
deigning|deign
happening|happen
wishing|wish
hoping|hope
agreeing|agree
pretending|pretend
swearing|swear
praying|pray
vowing|vow
voting|vote
appearing|appear
seeming|seem
caring|care
asserting|assert
contending|contend
remarking|remark
retorting|retort
intimating|intimate
exclaiming|exclaim
conjecturing|conjecture
alleging|allege
surmising|surmise
opining|opine
insinuating|insinuate
supposing|suppose
theorizing|theorize
attesting|attest
fantasizing|fantasize
musing|muse
speculating|speculate
concurring|concur
replying|reply
shouting|shout
whispering|whisper
arguing|argue
sighing|sigh
muttering|mutter
testifying|testify
commenting|comment
responding|respond
hinting|hint
reasoning|reason
bragging|brag
dreaming|dream
complaining|complain
thinking|think
mattering|matter
sufficing|suffice
insisting|insist
wondering|wonder
inquiring|inquire
going|go
staying|stay
acting|act
sounding|sound
looking|look
repenting|repent
disapproving|disapprove
talking|talk
consisting|consist
dying|die
lasting|last
waiting|wait
attempting|attempt
undertaking|undertake
deserving|deserve
managing|manage
plotting|plot
preferring|prefer
neglecting|neglect
affording|afford
committing|commit
professing|profess
desiring|desire
seeking|seek
declining|decline
failing|fail
hastening|hasten
volunteering|volunteer
aiming|aim
fighting|fight
threatening|threaten
meaning|mean
arranging|arrange
resolving|resolve
pledging|pledge
planning|plan
confessing|confess
deciding|decide
remembering|remember
forgetting|forget
learning|learn
proposing|propose
demanding|demand
begging|beg
pleading|plead
bearing|bear
loving|love
disliking|dislike
hating|hate
beginning|begin
continuing|continue
ceasing|cease
starting|start
stopping|stop
trying|try
recognizing|recognize
disputing|dispute
accepting|accept
calculating|calculate
recording|record
deducing|deduce
envisioning|envision
recounting|recount
signifying|signify
clarifying|clarify
disclosing|disclose
recollecting|recollect
adducing|adduce
positing|posit
reiterating|reiterate
inferring|infer
presupposing|presuppose
repeating|repeat
reflecting|reflect
countering|counter
signaling|signal
signalling|signal
providing|provide
doubting|doubt
reaffirming|reaffirm
sensing|sense
reckoning|reckon
regretting|regret
proclaiming|proclaim
ascertaining|ascertain
discerning|discern
stipulating|stipulate
affirming|affirm
certifying|certify
trusting|trust
postulating|postulate
ensuring|ensure
implying|imply
verifying|verify
boasting|boast
declaring|declare
imagining|imagine
fearing|fear
concluding|conclude
suspecting|suspect
conceding|concede
presuming|presume
emphasizing|emphasize
maintaining|maintain
acknowledging|acknowledge
noting|note
confirming|confirm
stressing|stress
assuming|assume
foreseeing|foresee
believing|believe
answering|answer
worrying|worry
protesting|protest
ruling|rule
adding|add
figuring|figure
predicting|predict
realizing|realize
discovering|discover
determining|determine
announcing|announce
saying|say
mentioning|mention
admitting|admit
recalling|recall
revealing|reveal
stating|state
observing|observe
indicating|indicate
guessing|guess
estimating|estimate
understanding|understand
noticing|notice
explaining|explain
demonstrating|demonstrate
knowing|know
requesting|request
feeling|feel
minding|mind
studying|study
discussing|discuss
opposing|oppose
enjoying|enjoy
advocating|advocate
contemplating|contemplate
entailing|entail
necessitating|necessitate
justifying|justify
risking|risk
avoiding|avoid
involving|involve
anticipating|anticipate
favoring|favor
finishing|finish
practicing|practice
resisting|resist
quitting|quit
turning|turn
becoming|become
remaining|remain
growing|grow
approving|approve
disposing|dispose
conceiving|conceive
speaking|speak
tasting|taste
smelling|smell
taking|take
putting|put
costing|cost
finding|find
getting|get
leaving|leave
keeping|keep
pacing|pace
watching|watch
tracking|track
setting|set
loosing|loose
freeing|free
holding|hold
hostaging|hostage
expecting|expect
claiming|claim
intending|intend
daring|dare
liking|like
offering|offer
refusing|refuse
wanting|want
needing|need
choosing|choose
preparing|prepare
pressing|press
requiring|require
commanding|command
ordering|order
urging|urge
considering|consider
perceiving|perceive
reporting|report
cautioning|caution
warning|warn
advising|advise
hearing|hear
seeing|see
owing|owe
delivering|deliver
according|accord
awarding|award
terming|term
granting|grant
begrudging|begrudge
assigning|assign
renaming|rename
repaying|repay
dubbing|dub
entitling|entitle
fining|fine
giving|give
sending|send
buying|buy
bringing|bring
lending|lend
issuing|issue
handing|hand
passing|pass
paying|pay
selling|sell
dealing|deal
calling|call
reading|read
writing|write
charging|charge
allowing|allow
promising|promise
showing|show
teaching|teach
compelling|compel
forcing|force
designing|design
permitting|permit
authorizing|authorize
causing|cause
enabling|enable
pressuring|pressure
training|train
sentencing|sentence
prompting|prompt
spurring|spur
inviting|invite
reelecting|reelect
encouraging|encourage
drafting|draft
hiring|hire
enticing|entice
inspiring|inspire
aiding|aid
forbidding|forbid
employing|employ
educating|educate
tempting|tempt
condemning|condemn
commissioning|commission
counseling|counsel
inducing|induce
instructing|instruct
licensing|license
inciting|incite
nominating|nominate
destining|destine
provoking|provoke
challenging|challenge
exhorting|exhort
imploring|implore
motivating|motivate
impelling|impel
using|use
electing|elect
appointing|appoint
naming|name
programming|program
obliging|oblige
convincing|convince
persuading|persuade
telling|tell
asking|ask
helping|help
reminding|remind
informing|inform
reassuring|reassure
alerting|alert
guaranteeing|guarantee
notifying|notify
forewarning|forewarn
assuring|assure
letting|let
watching|watch
appreciating|appreciate
spending|spend
making|make
rendering|render
deeming|deem
depriving|deprive
accusing|accuse
acquitting|acquit
purging|purge
disabusing|disabuse
exonerating|exonerate
absolving|absolve
robbing|rob
convicting|convict
clearing|clear
betting|bet
bothering|bother
surprising|surprise
alarming|alarm
amazing|amaze
amusing|amuse
astonishing|astonish
astounding|astound
exciting|excite
depressing|depress
disgusting|disgust
distressing|distress
dismaying|dismay
irritating|irritate
embarrassing|embarrass
annoying|annoy
proving|prove
suggesting|suggest
recommending|recommend
denying|deny
describing|describe
portraying|portray
depicting|depict
regarding|regard
viewing|view
characterizing|characterize
reading|read
writing|write
seeming|seem
appearing|appear
saying|say
telling|tell
asking|ask
saying|say
voting|vote
doubling|double
tripling|triple
quadrupling|quadruple
quintupling|quintuple
abating|abate
abounding|abound
about-facing|about-face
absconding|abscond
abstaining|abstain
acceding|accede
accounting|account
accruing|accrue
aching|ache
acquiescing|acquiesce
ad-libbing|ad-lib
adhering|adhere
adjoining|adjoin
alighting|alight
alluding|allude
allying|ally
amounting|amount
apologizing|apologize
appertaining|appertain
aquaplaning|aquaplane
arising|arise
arriving|arrive
assenting|assent
atoning|atone
atrophying|atrophy
baaing|baa
babbling|babble
babysitting|babysit
backfiring|backfire
backpedalling|backpedal
backsliding|backslide
backspacing|backspace
balking|balk
ballooning|balloon
banqueting|banquet
bantering|banter
barking|bark
barnstorming|barnstorm
basking|bask
bawling|bawl
baying|bay
beetling|beetle
behaving|behave
belching|belch
bellyaching|bellyache
belonging|belong
bickering|bicker
bicycling|bicycle
billowing|billow
blabbering|blabber
blathering|blather
blazing|blaze
bleating|bleat
bleeding|bleed
bleeping|bleep
blooming|bloom
blossoming|blossom
blubbering|blubber
blundering|blunder
blushing|blush
boding|bode
booming|boom
braking|brake
brawling|brawl
braying|bray
bristling|bristle
brooding|brood
browsing|browse
bubbling|bubble
budding|bud
bullshitting|bullshit
bunking|bunk
burbling|burble
burgeoning|burgeon
burping|burp
bustling|bustle
cackling|cackle
campaigning|campaign
canoeing|canoe
cantering|canter
capering|caper
capitulating|capitulate
careening|careen
carolling|carol
carousing|carouse
cascading|cascade
castling|castle
catering|cater
caterwauling|caterwaul
cavilling|cavil
cavorting|cavort
chafing|chafe
chattering|chatter
cheeping|cheep
chirping|chirp
chirruping|chirrup
chortling|chortle
chuckling|chuckle
chugging|chug
chumming|chum
clacking|clack
clambering|clamber
clamoring|clamor
clamouring|clamour
clanking|clank
clashing|clash
clattering|clatter
clerking|clerk
climaxing|climax
clinging|cling
clucking|cluck
clunking|clunk
clustering|cluster
co-operating|co-operate
coalescing|coalesce
coasting|coast
coexisting|coexist
cohabiting|cohabit
cohering|cohere
coinciding|coincide
collaborating|collaborate
colliding|collide
commentating|commentate
commiserating|commiserate
communing|commune
competing|compete
complying|comply
compromising|compromise
confabbing|confab
confabulating|confabulate
conflicting|conflict
conforming|conform
congealing|congeal
congregating|congregate
conniving|connive
consorting|consort
conspiring|conspire
convalescing|convalesce
converging|converge
conversing|converse
cooing|coo
cooperating|cooperate
coping|cope
copulating|copulate
corresponding|correspond
cowering|cower
crackling|crackle
crash-diving|crash-dive
creaking|creak
cresting|crest
cringing|cringe
croaking|croak
crowing|crow
crusading|crusade
culminating|culminate
curtseying|curtsey
curtsying|curtsy
cycling|cycle
dabbling|dabble
dallying|dally
dawdling|dawdle
dawning|dawn
daydreaming|daydream
decamping|decamp
decaying|decay
defaulting|default
defecating|defecate
defecting|defect
degenerating|degenerate
deliberating|deliberate
delving|delve
demurring|demur
departing|depart
depending|depend
deplaning|deplane
depreciating|depreciate
deputizing|deputize
desisting|desist
despairing|despair
deteriorating|deteriorate
detracting|detract
deviating|deviate
devolving|devolve
dieting|diet
differing|differ
digressing|digress
dilly-dallying|dilly-dally
disagreing|disagree
disappearing|disappear
discoursing|discourse
discriminating|discriminate
disembarking|disembark
disintegrating|disintegrate
disrobing|disrobe
dissembling|dissemble
dissenting|dissent
dithering|dither
diverging|diverge
doddering|dodder
domineering|domineer
doodling|doodle
doting|dote
double-parking|double-park
dovetailing|dovetail
drawling|drawl
drizzling|drizzle
drooling|drool
duelling|duel
dwelling|dwell
dwindling|dwindle
eavesdropping|eavesdrop
ebbing|ebb
economizing|economize
eddying|eddy
effervescing|effervesce
elapsing|elapse
eloping|elope
emanating|emanate
embarking|embark
emerging|emerge
emigrating|emigrate
encamping|encamp
encroaching|encroach
enquiring|enquire
ensuing|ensue
erring|err
erupting|erupt
evaporating|evaporate
excelling|excel
existing|exist
exiting|exit
expatiating|expatiate
experimenting|experiment
expiring|expire
expostulating|expostulate
exulting|exult
fainting|faint
faltering|falter
faring|fare
farting|fart
fasting|fast
fawning|fawn
feinting|feint
festering|fester
fibbing|fib
fidgeting|fidget
filibustering|filibuster
fizzing|fizz
flailing|flail
flaking|flake
flaming|flame
flickering|flicker
flinching|flinch
flirting|flirt
flitting|flit
flopping|flop
floundering|flounder
flourishing|flourish
flowering|flower
fluctuating|fluctuate
fluttering|flutter
fly-fishing|fly-fish
foraging|forage
foregathering|foregather
fornicating|fornicate
fossilizing|fossilize
foxhunting|foxhunt
fragmenting|fragment
fraternizing|fraternize
freelancing|freelance
freewheeling|freewheel
fretting|fret
frothing|froth
frowning|frown
fulminating|fulminate
fuming|fume
functioning|function
fussing|fuss
gallivanting|gallivant
galumphing|galumph
gambolling|gambol
gaping|gape
gardening|garden
gawping|gawp
gazing|gaze
gelling|gel
genuflecting|genuflect
gesticulating|gesticulate
gesturing|gesture
gibing|gibe
giggling|giggle
glaring|glare
gleaming|gleam
gliding|glide
glimmering|glimmer
glinting|glint
glistening|glisten
glittering|glitter
gloating|gloat
globetrotting|globetrot
glorying|glory
glowing|glow
glowering|glower
goggling|goggle
golfing|golf
gossiping|gossip
graduating|graduate
grappling|grapple
gravitating|gravitate
graying|gray
grazing|graze
greying|grey
grimacing|grimace
grinning|grin
grooving|groove
grouching|grouch
grousing|grouse
grovelling|grovel
guffawing|guffaw
gurgling|gurgle
gybing|gybe
gyrating|gyrate
haggling|haggle
hankering|hanker
harking|hark
harping|harp
hawing|haw
hearkening|hearken
heeling|heel
hibernating|hibernate
hiccoughing|hiccough
hiccupping|hiccup
hinging|hinge
hissing|hiss
hitchhiking|hitchhike
hobnobbing|hobnob
hollering|holler
honeymooning|honeymoon
hovering|hover
huddling|huddle
huffing|huff
hungering|hunger
hurtling|hurtle
ice-skating|ice-skate
immigrating|immigrate
impending|impend
impinging|impinge
inching|inch
innovating|innovate
interacting|interact
interceding|intercede
intercommunicating|intercommunicate
interfering|interfere
intermarrying|intermarry
intermingling|intermingle
intervening|intervene
introspecting|introspect
intruding|intrude
inveighing|inveigh
itching|itch
jabbering|jabber
jack-knifing|jack-knife
jaunting|jaunt
jawing|jaw
jaywalking|jaywalk
jelling|jell
jesting|jest
jibing|jibe
jiving|jive
jockeying|jockey
joking|joke
journeying|journey
jousting|joust
kowtowing|kowtow
lagging|lag
languishing|languish
lapsing|lapse
laughing|laugh
leafing|leaf
leering|leer
legislating|legislate
liaising|liaise
lip-reading|lip-read
lisping|lisp
living|live
loafing|loaf
loitering|loiter
lolling|loll
longing|long
loping|lope
lounging|lounge
lumbering|lumber
lurking|lurk
lusting|lust
luxuriating|luxuriate
majoring|major
malfunctioning|malfunction
malingering|malinger
marvelling|marvel
masquerading|masquerade
materializing|materialize
matriculating|matriculate
maturating|maturate
maturing|mature
maundering|maunder
meandering|meander
meddling|meddle
meditating|meditate
menstruating|menstruate
metamorphosing|metamorphose
mewing|mew
miaouing|miaou
miaowing|miaow
migrating|migrate
militating|militate
mingling|mingle
ministering|minister
misbehaving|misbehave
misfiring|misfire
molting|molt
monkeying|monkey
mooing|moo
mooching|mooch
moping|mope
moralizing|moralize
moseying|mosey
motioning|motion
motoring|motor
mushrooming|mushroom
mutinying|mutiny
name-dropping|name-drop
napping|nap
nattering|natter
necking|neck
neighing|neigh
nesting|nest
networking|network
niggling|niggle
nosediving|nosedive
noshing|nosh
objecting|object
occurring|occur
officiating|officiate
orating|orate
oscillating|oscillate
outgoing|outgo
overacting|overact
overbidding|overbid
overeating|overeat
overlying|overlie
overreacting|overreact
oversleeping|oversleep
paling|pale
palling|pall
palpitating|palpitate
pandering|pander
panhandling|panhandle
panicking|panic
panting|pant
parachuting|parachute
parleying|parley
partaking|partake
participating|participate
pattering|patter
pausing|pause
peaking|peak
pearling|pearl
peeping|peep
perambulating|perambulate
percolating|percolate
perishing|perish
persevering|persevere
persisting|persist
perspiring|perspire
pertaining|pertain
philandering|philander
philosophizing|philosophize
picnicking|picnic
piddling|piddle
pimping|pimp
pinging|ping
pirouetting|pirouette
pivoting|pivot
plodding|plod
plummetting|plummet
politicking|politick
pontificating|pontificate
poring|pore
posturing|posture
pottering|potter
pouncing|pounce
pouting|pout
powwowing|powwow
prancing|prance
prating|prate
prattling|prattle
pre-existing|pre-exist
predominating|predominate
presiding|preside
prevailing|prevail
prevaricating|prevaricate
preying|prey
primping|primp
procrastinating|procrastinate
procreating|procreate
profiting|profit
profiteering|profiteer
progressing|progress
proliferating|proliferate
propagandizing|propagandize
proselytizing|proselytize
prospering|prosper
protruding|protrude
pub-crawling|pub-crawl
pulsating|pulsate
pulsing|pulse
punning|pun
purring|purr
pussyfooting|pussyfoot
putrefying|putrefy
puttering|putter
quacking|quack
quaking|quake
quarrelling|quarrel
quarrying|quarry
quavering|quaver
questing|quest
queueing|queue
quibbling|quibble
quipping|quip
quivering|quiver
racketing|racket
rafting|raft
raging|rage
railing|rail
raining|rain
rambling|ramble
rampaging|rampage
ranging|range
rankling|rankle
ranting|rant
rasping|rasp
ratting|rat
raving|rave
re-echoing|re-echo
reacting|react
reappearing|reappear
rebelling|rebel
rebounding|rebound
receding|recede
reclining|recline
recoiling|recoil
reconnoitring|reconnoitre
reconverting|reconvert
recriminating|recriminate
recuperating|recuperate
recurring|recur
redounding|redound
refraining|refrain
regressing|regress
reigning|reign
rejoicing|rejoice
relapsing|relapse
relenting|relent
relying|rely
reminiscing|reminisce
remonstrating|remonstrate
rendezvousing|rendezvous
reneging|renege
residing|reside
resigning|resign
resonating|resonate
resorting|resort
resounding|resound
resting|rest
resulting|result
resurfacing|resurface
retaliating|retaliate
retching|retch
retreating|retreat
retrenching|retrench
retrograding|retrograde
retrogressing|retrogress
revelling|revel
reverberating|reverberate
reverting|revert
revolting|revolt
revolving|revolve
rhapsodizing|rhapsodize
rioting|riot
ripening|ripen
riposting|riposte
rippling|ripple
rocketing|rocket
romancing|romance
romping|romp
rooming|room
roosting|roost
rough-housing|rough-house
roving|rove
rumbling|rumble
ruminating|ruminate
rummaging|rummage
rusting|rust
sagging|sag
salivating|salivate
sauntering|saunter
scampering|scamper
scavenging|scavenge
scheming|scheme
scintillating|scintillate
scowling|scowl
scramming|scram
screeching|screech
scrimping|scrimp
scrounging|scrounge
scuffling|scuffle
seceding|secede
seesawing|seesaw
seething|seethe
sermonizing|sermonize
shillyshallying|shillyshally
shimmering|shimmer
shitting|shit
shivering|shiver
shrimping|shrimp
shuddering|shudder
siding|side
sidling|sidle
simmering|simmer
simpering|simper
sinning|sin
sizzling|sizzle
skating|skate
skedaddling|skedaddle
skimping|skimp
skirmishing|skirmish
skulking|skulk
skylarking|skylark
skyrocketing|skyrocket
slackening|slacken
slavering|slaver
sleeping|sleep
sleeting|sleet
slithering|slither
slobbering|slobber
slogging|slog
slouching|slouch
slumming|slum
slumbering|slumber
smarting|smart
smiling|smile
smirking|smirk
smouldering|smoulder
snaking|snake
sneering|sneer
sneezing|sneeze
snickering|snicker
sniffling|sniffle
sniggering|snigger
sniping|snipe
snitching|snitch
snivelling|snivel
snooping|snoop
snoozing|snooze
snoring|snore
snowing|snow
snowballing|snowball
snuffling|snuffle
sobbing|sob
sojourning|sojourn
soliloquizing|soliloquize
somersaulting|somersault
souring|sour
sparring|spar
sparkling|sparkle
specializing|specialize
speechifying|speechify
spiralling|spiral
splurging|splurge
spluttering|splutter
sprawling|sprawl
sprinting|sprint
sputtering|sputter
squabbling|squabble
squalling|squall
squawking|squawk
squeaking|squeak
squealing|squeal
squinting|squint
squirming|squirm
stagnating|stagnate
stemming|stem
straggling|straggle
straying|stray
striving|strive
struggling|struggle
stuttering|stutter
subbing|sub
subscribing|subscribe
subsiding|subside
subsisting|subsist
succumbing|succumb
sulking|sulk
summering|summer
sunbathing|sunbathe
supping|sup
supervening|supervene
surfacing|surface
surging|surge
swaggering|swagger
swarming|swarm
sweltering|swelter
swerving|swerve
swirling|swirl
swooning|swoon
sympathizing|sympathize
tampering|tamper
tarrying|tarry
tattling|tattle
taxiing|taxi
teeming|teem
teetering|teeter
teething|teethe
temporizing|temporize
thriving|thrive
throbbing|throb
thudding|thud
tingling|tingle
tinkering|tinker
tinkling|tinkle
tiptoeing|tiptoe
tittering|titter
tittle-tattling|tittle-tattle
toadying|toady
tobogganing|toboggan
toiling|toil
tolling|toll
tootling|tootle
tonning|ton
tottering|totter
touch-typing|touch-type
towering|tower
toying|toy
traipsing|traipse
transpiring|transpire
traveling|travel
travelling|travel
trekking|trek
trembling|tremble
trespassing|trespass
trifling|trifle
triumphing|triumph
trundling|trundle
tunnelling|tunnel
tussling|tussle
tweeting|tweet
twinkling|twinkle
twitching|twitch
twittering|twitter
ululating|ululate
underacting|underact
undulating|undulate
urinating|urinate
vacationing|vacation
vacillating|vacillate
vamoosing|vamoose
vamping|vamp
vanishing|vanish
vaulting|vault
vegetating|vegetate
verging|verge
vying|vie
vouching|vouch
voyaging|voyage
waddling|waddle
waffling|waffle
wallowing|wallow
waltzing|waltz
wandering|wander
waning|wane
wanking|wank
warbling|warble
wavering|waver
weeping|weep
welshing|welsh
weltering|welter
wheezing|wheeze
whimpering|whimper
whinnying|whinny
whirring|whir
whirring|whirr
wilting|wilt
wincing|wince
winking|wink
wiretapping|wiretap
wisecracking|wisecrack
withering|wither
wobbling|wobble
womanizing|womanize
wrangling|wrangle
wriggling|wriggle
writhing|writhe
yachting|yacht
yammering|yammer
yapping|yap
yawning|yawn
yearning|yearn
yelping|yelp
yenning|yen
zigzagging|zigzag
abdicating|abdicate
abiding|abide
aborting|abort
accelerating|accelerate
acclimating|acclimate
acclimatizing|acclimatize
accumulating|accumulate
acidifying|acidify
adapting|adapt
adjourning|adjourn
adjudicating|adjudicate
adjusting|adjust
advancing|advance
advertising|advertise
affiliating|affiliate
aging|age
aggregating|aggregate
agitating|agitate
ailing|ail
aligning|align
altering|alter
alternating|alternate
amalgamating|amalgamate
anchoring|anchor
angling|angle
appealing|appeal
applauding|applaud
applying|apply
approaching|approach
approximating|approximate
arbitrating|arbitrate
arching|arch
articulating|articulate
ascending|ascend
assembling|assemble
assimilating|assimilate
assisting|assist
associating|associate
attending|attend
auditioning|audition
auguring|augur
availing|avail
awakening|awaken
bagging|bag
banding|band
banking|bank
bargaining|bargain
bartering|barter
batting|bat
bathing|bath
bathing|bathe
baulking|baulk
beckoning|beckon
benefiting|benefit
berthing|berth
bifurcating|bifurcate
blabbing|blab
blackening|blacken
blanching|blanch
blaspheming|blaspheme
bleaching|bleach
blending|blend
blinking|blink
blistering|blister
bluffing|bluff
blurring|blur
boggling|boggle
bonding|bond
boning|bone
booing|boo
bordering|border
borrowing|borrow
breastfeeding|breastfeed
breeding|breed
brewing|brew
bridling|bridle
broadcasting|broadcast
broadening|broaden
broiling|broil
browning|brown
budging|budge
buffeting|buffet
buggering|bugger
bullying|bully
burgling|burgle
burnishing|burnish
burrowing|burrow
cabling|cable
calcifying|calcify
canceling|cancel
cancelling|cancel
canvassing|canvass
capitalizing|capitalize
capsizing|capsize
carping|carp
celebrating|celebrate
centering|center
centring|centre
chanting|chant
charring|char
circling|circle
circulating|circulate
clanging|clang
clapping|clap
clasping|clasp
cleaving|cleave
clinching|clinch
clinking|clink
clotting|clot
cloying|cloy
clutching|clutch
co-starring|co-star
coaching|coach
coagulating|coagulate
coaxing|coax
cogitating|cogitate
collapsing|collapse
combining|combine
commencing|commence
commingling|commingle
communicating|communicate
commuting|commute
comparing|compare
compensating|compensate
composing|compose
computing|compute
concentrating|concentrate
condensing|condense
conducting|conduct
confederating|confederate
conferring|confer
confiding|confide
conjoining|conjoin
conjugating|conjugate
consolidating|consolidate
consulting|consult
contesting|contest
contrasting|contrast
contributing|contribute
convening|convene
converting|convert
correlating|correlate
corroding|corrode
corrupting|corrupt
couching|couch
counterattacking|counterattack
crashing|crash
crash-landing|crash-land
craving|crave
creasing|crease
cribbing|crib
crinkling|crinkle
crisscrossing|crisscross
crocheting|crochet
crooning|croon
crosschecking|crosscheck
crystallizing|crystallize
cuddling|cuddle
curdling|curdle
cursing|curse
curving|curve
dabbing|dab
damping|damp
dangling|dangle
darkening|darken
darning|darn
dating|date
debarking|debark
debating|debate
decelerating|decelerate
decomposing|decompose
decreasing|decrease
deepening|deepen
deflecting|deflect
delaying|delay
delighting|delight
democratizing|democratize
derailing|derail
deriving|derive
derogating|derogate
descending|descend
detonating|detonate
developing|develop
dictating|dictate
differentiating|differentiate
diffusing|diffuse
digesting|digest
dilating|dilate
dimming|dim
diminishing|diminish
dinning|din
dipping|dip
disarming|disarm
disbanding|disband
discharging|discharge
discontinuing|discontinue
disengaging|disengage
disentangling|disentangle
dismounting|dismount
dispensing|dispense
dispersing|disperse
dissipating|dissipate
dissolving|dissolve
distending|distend
distinguishing|distinguish
dive-bombing|dive-bomb
diversifying|diversify
divining|divine
docking|dock
dodging|dodge
dreading|dread
dribbling|dribble
drilling|drill
dripping|drip
drooping|droop
dulling|dull
echoing|echo
ejaculating|ejaculate
ejecting|eject
elaborating|elaborate
elongating|elongate
embroidering|embroider
ending|end
enduring|endure
engaging|engage
enlisting|enlist
enroling|enrol
enrolling|enroll
entering|enter
entertaining|entertain
enunciating|enunciate
eroding|erode
escalating|escalate
escaping|escape
etching|etch
evacuating|evacuate
evolving|evolve
exaggerating|exaggerate
exercising|exercise
exhaling|exhale
expanding|expand
exploding|explode
exploring|explore
expounding|expound
extemporizing|extemporize
extending|extend
extrapolating|extrapolate
fastening|fasten
feasting|feast
fermenting|ferment
ferrying|ferry
fiddling|fiddle
fielding|field
filming|film
fitting|fit
fixating|fixate
flagging|flag
flapping|flap
flashing|flash
fleeing|flee
focusing|focus
footing|foot
forbearing|forbear
foreclosing|foreclose
forgiving|forgive
forming|form
foundering|founder
fracturing|fracture
fraying|fray
fronting|front
frosting|frost
fuelling|fuel
fumbling|fumble
furling|furl
fusing|fuse
gagging|gag
gaining|gain
gambling|gamble
gargling|gargle
gasifying|gasify
gasping|gasp
generalizing|generalize
germinating|germinate
glancing|glance
glossing|gloss
gnashing|gnash
gnawing|gnaw
governing|govern
grasping|grasp
grating|grate
grieving|grieve
grinding|grind
groaning|groan
grounding|ground
groping|grope
grouping|group
growling|growl
grumbling|grumble
grunting|grunt
hailing|hail
hardening|harden
harmonizing|harmonize
hatching|hatch
heaving|heave
heckling|heckle
hedging|hedge
heightening|heighten
hemming|hem
hoarding|hoard
hoeing|hoe
honking|honk
hooting|hoot
howling|howl
hugging|hug
humming|hum
hurting|hurt
hushing|hush
hustling|hustle
icing|ice
idling|idle
igniting|ignite
improving|improve
improvising|improvise
inclining|incline
incorporating|incorporate
increasing|increase
incubating|incubate
indenting|indent
indulging|indulge
industrializing|industrialize
infringing|infringe
inhaling|inhale
intensifying|intensify
interbreeding|interbreed
interconnecting|interconnect
interlocking|interlock
intermixing|intermix
interning|intern
interpreting|interpret
interrelating|interrelate
interrupting|interrupt
intersecting|intersect
intertwining|intertwine
interviewing|interview
intriguing|intrigue
investigating|invest
investing|investigate
ionizing|ionize
jabbing|jab
jangling|jangle
jeering|jeer
jigging|jig
jiggling|jiggle
jingling|jingle
jolting|jolt
jostling|jostle
judging|judge
juggling|juggle
kidding|kid
kindling|kindle
knitting|knit
labouring|labour
lamenting|lament
landing|land
latching|latch
launching|launch
lecturing|lecture
lengthening|lengthen
lessening|lessen
leveling|level
levelling|level
levitating|levitate
lighting|light
liquefying|liquefy
liquidating|liquidate
litigating|litigate
littering|litter
lobbying|lobby
locating|locate
lodging|lodge
looping|loop
lunching|lunch
maneuvering|maneuver
manoeuvring|manoeuvre
marinating|marinate
massing|mass
masturbating|masturbate
mating|mate
mediating|mediate
meeting|meet
mending|mend
merging|merge
meshing|mesh
milling|mill
miming|mime
mining|mine
miscalculating|miscalculate
miscarrying|miscarry
miscounting|miscount
misdealing|misdeal
misjudging|misjudge
misting|mist
mistunderstanding|misunderstand
moaning|moan
mobilizing|mobilize
modeling|model
modelling|model
moderating|moderate
modernizing|modernize
moistening|moisten
mooning|moon
moulding|mould
moulting|moult
mounting|mount
mourning|mourn
mowing|mow
muddling|muddle
multiplying|multiply
mumbling|mumble
munching|munch
murmuring|murmur
narrowing|narrow
navigating|navigate
nearing|near
negotiating|negotiate
nibbling|nibble
nipping|nip
nuzzling|nuzzle
obeying|obey
obsessing|obsess
ogling|ogle
operating|operate
orbiting|orbit
originating|originate
ossifying|ossify
overcharging|overcharge
overdrawing|overdraw
overdressing|overdress
overfeeding|overfeed
overflowing|overflow
overheating|overheat
overindulging|overindulge
overlapping|overlap
overproducing|overproduce
overreaching|overreach
overspending|overspend
overtrumping|overtrump
overturning|overturn
overworking|overwork
oxidizing|oxidize
pacing|pace
paddling|paddle
painting|paint
parading|parade
parking|park
parting|part
pealing|peal
pecking|peck
pedalling|pedal
peddling|peddle
penetrating|penetrate
perching|perch
performing|perform
petitioning|petition
petrifying|petrify
picketing|picket
pillaging|pillage
pioneering|pioneer
pitching|pitch
plundering|plunder
poaching|poach
poising|poise
polling|poll
posing|pose
practising|practise
preaching|preach
privatizing|privatize
programing|program
programming|programme
projecting|project
promenading|promenade
proofreading|proofread
propagating|propagate
prowling|prowl
puking|puke
puncturing|puncture
punting|punt
putting|putt
puzzling|puzzle
qualifying|qualify
quickening|quicken
quietening|quieten
racing|race
radiating|radiate
radioing|radio
rallying|rally
ramifying|ramify
ranking|rank
rapping|rap
rating|rate
rattling|rattle
ravelling|ravel
re-forming|re-form
re-opening|re-open
readjusting|readjust
rearing|rear
rearming|rearm
reassembling|reassemble
rebuilding|rebuild
recanting|recant
recapping|recap
recapitulating|recapitulate
receiving|receive
reciprocating|reciprocate
reconvening|reconvene
recovering|reconvert
recruiting|recover
reddening|recruit
redoubling|redden
referring|redouble
reforming|refer
refueling|reform
refuelling|refuel
regenerating|regenerate
registering|register
regrouping|regroup
rehearsing|rehearse
reinvesting|reinvest
rekindling|rekindle
relating|relate
relaxing|relax
relocating|relocate
remarrying|remarry
remitting|remit
remounting|remount
renegotiating|renegotiate
reopening|reopen
reorganizing|reorganize
repairing|repair
reproducing|reproduce
resettling|resettle
restarting|restart
resuming|resume
resuscitating|resuscitate
retailing|retail
retiring|retire
retooling|retool
returning|return
reuniting|reunite
reversing|reverse
reviving|revive
rhyming|rhyme
ricocheting|ricochet
ringing|ring
ringing|ring
roaming|roam
roaring|roar
roasting|roast
rotating|rotate
rousing|rouse
rowing|row
ruffling|ruffle
rupturing|rupture
rustling|rustle
sacrificing|sacrifice
saluting|salute
sawing|saw
scanning|scan
scattering|scatter
scoffing|scoff
scolding|scold
scoring|score
scrambling|scramble
scrawling|scrawl
scribbling|scribble
scrubbing|scrub
sculpturing|sculpture
searching|search
seizing|seize
separating|separate
severing|sever
shading|shade
shattering|shatter
shelling|shell
shoplifting|shoplift
short-circuiting|short-circuit
shortening|shorten
shoving|shove
showering|shower
shrieking|shriek
shrinking|shrink
shrinking|shrink
shuffling|shuffle
sifting|sift
singing|sing
singeing|singe
sinking|sink
sinking|sink
sipping|sip
slamming|slam
slanting|slant
sloshing|slosh
smacking|smack
smearing|smear
smoking|smoke
smudging|smudge
snarling|snarl
snipping|snip
snorting|snort
snuggling|snuggle
socializing|socialize
solidifying|solidify
sowing|sow
spattering|spatter
spawning|spawn
splashing|splash
splaying|splay
splintering|splinter
spoiling|spoil
sponging|sponge
sporting|sport
spouting|spout
spring-cleaning|spring-clean
spying|spy
squashing|squash
stabilizing|stabilize
staining|stain
stalking|stalk
stalling|stall
stammering|stammer
stampeding|stampede
staring|stare
steadying|steady
steeping|steep
steepening|steepen
steering|steer
stewing|stew
stifling|stifle
stinging|sting
stinting|stint
stonewalling|stonewall
straining|strain
stratifying|stratify
streaking|streak
strengthening|strengthen
strumming|strum
stumping|stump
subcontracting|subcontract
subdividing|subdivide
subleasing|sublease
subletting|sublet
submerging|submerge
submitting|submit
substituting|substitute
succeeding|succeed
suing|sue
suffering|suffer
suffocating|suffocate
supervising|supervise
supplicating|supplicate
surrendering|surrender
surviving|survive
swallowing|swallow
swapping|swap
swaying|sway
sweating|sweat
swishing|swish
swivelling|swivel
synchronizing|synchronize
tackling|tackle
tagging|tag
tanning|tan
tapping|tap
tarnishing|tarnish
telegraphing|telegraph
telephoning|telephone
tending|tend
terminating|terminate
thawing|thaw
thrashing|thrash
thrilling|thrill
thronging|throng
throttling|throttle
thumping|thump
thundering|thunder
tickling|tickle
tilting|tilt
toasting|toast
tooting|toot
tracing|trace
trading|trade
transferring|transfer
transgressing|transgress
translating|translate
transplanting|transplant
treating|treat
trebling|treble
trotting|trot
trumping|trump
trumpeting|trumpet
tugging|tug
twirling|twirl
umpiring|umpire
unbending|unbend
uncurling|uncurl
underbidding|underbid
underspending|underspend
undressing|undress
unfastening|unfasten
unfolding|unfold
unhitching|unhitch
unifying|unify
uniting|unite
unloading|unload
unlocking|unlock
unpacking|unpack
unraveling|unravel
unrolling|unroll
unscrewing|unscrew
untying|untie
unwinding|unwind
unwrapping|unwrap
urbanizing|urbanize
vaporizing|vaporize
varying|vary
venturing|venture
vesting|vest
vibrating|vibrate
visiting|visit
volleying|volley
vomiting|vomit
wading|wade
wagging|wag
wailing|wail
wakening|waken
warping|warp
watering|water
waving|wave
waxing|wax
weakening|weaken
wedding|wed
welding|weld
wheeling|wheel
whining|whine
whirling|whirl
whistling|whistle
whitening|whiten
whittling|whittle
widening|widen
wiggling|wiggle
wiring|wire
withdrawing|withdraw
worsening|worsen
worshipping|worship
wrestling|wrestle
wrinkling|wrinkle
yelling|yell
yielding|yield
yodelling|yodel
abandoning|abandon
abasing|abase
abbreviating|abbreviate
abducting|abduct
abetting|abet
abhorring|abhor
abolishing|abolish
abridging|abridge
abrogating|abrogate
absorbing|absorb
abstracting|abstract
abusing|abuse
abutting|abut
accenting|accent
accentuating|accentuate
accessing|access
acclaiming|acclaim
accommodating|accommodate
accompanying|accompany
accomplishing|accomplish
accosting|accost
accrediting|accredit
accustoming|accustom
achieving|achieve
acquainting|acquaint
acquiring|acquire
activating|activate
addicting|addict
addling|addle
addressing|address
adjudging|adjudge
administering|administer
admiring|admire
admonishing|admonish
adopting|adopt
adoring|adore
adorning|adorn
adulterating|adulterate
adumbrating|adumbrate
aerating|aerate
affecting|affect
affixing|affix
afflicting|afflict
aggrandizing|aggrandize
aggravating|aggravate
airing|air
alienating|alienate
allaying|allay
alleviating|alleviate
allocating|allocate
allotting|allot
amassing|amass
ambushing|ambush
ameliorating|ameliorate
amending|amend
amortizing|amortize
amplifying|amplify
amputating|amputate
anaesthetizing|anaesthetize
analysing|analyse
analyzing|analyze
anathematizing|anathematize
anesthetizing|anesthetize
angering|anger
anglicizing|anglicize
animating|animate
annexing|annex
annihilating|annihilate
annointing|annoint
annotating|annotate
annulling|annul
anointing|anoint
antagonizing|antagonize
antedating|antedate
aping|ape
appalling|appal
appeasing|appease
appending|append
apportioning|apportion
appraising|appraise
apprehending|apprehend
apprenticing|apprentice
apprising|apprise
appropriating|appropriate
arming|arm
arousing|arouse
arraigning|arraign
arraying|array
arresting|arrest
arrogating|arrogate
ascribing|ascribe
asphalting|asphalt
asphyxiating|asphyxiate
aspirating|aspirate
assailing|assail
assassinating|assassinate
assaulting|assault
assaying|assay
assessing|assess
assuaging|assuage
atomizing|atomize
attaching|attach
attacking|attack
attaining|attain
attenuating|attenuate
attiring|attire
attracting|attract
attributing|attribute
attuning|attune
auditing|audit
augmenting|augment
authenticating|authenticate
autographing|autograph
automating|automate
avenging|avenge
averring|aver
averting|avert
awaiting|await
awing|awe
axing|ax
axing|axe
backdating|backdate
badgering|badger
baffling|baffle
baiting|bait
baking|bake
balancing|balance
baling|bale
bamboozling|bamboozle
banning|ban
bandaging|bandage
banishing|banish
bankrupting|bankrupt
baptizing|baptize
barbarizing|barbarize
barbecuing|barbecue
baring|bare
barrelling|barrel
barricading|barricade
bashing|base
basing|bash
basting|baste
battering|batter
battling|battle
beatifying|beatify
beautifying|beautify
bedevilling|bedevil
befalling|befall
befitting|befit
befouling|befoul
befriending|befriend
begetting|beget
beggaring|beggar
beguiling|beguile
beheading|behead
beholding|behold
belabouring|belabour
belying|belie
belittling|belittle
belting|belt
bemoaning|bemoan
bequeathing|bequeath
berating|berate
bereaving|bereave
beseeching|beseech
besieging|besiege
besmirching|besmirch
bespeaking|bespeak
besting|best
bestirring|bestir
bestowing|bestow
bestrewing|bestrew
bestriding|bestride
betokening|betoken
betraying|betray
bevelling|bevel
bewailing|bewail
bewildering|bewilder
bewitching|bewitch
biasing|bias
biding|bide
biffing|biff
bilking|bilk
billing|bill
billeting|billet
birching|birch
bisecting|bisect
blackballing|blackball
blacklisting|blacklist
blackmailing|blackmail
blaming|blame
blanketing|blanket
blasting|blast
blazoning|blazon
blemishing|blemish
blessing|bless
blighting|blight
blindfolding|blind
blinding|blindfold
blitzing|blitz
blockading|blockade
blow-drying|blow-dry
bludgeoning|bludgeon
blue-pencilling|blue-pencil
blunting|blunt
bolstering|bolster
bombing|bomb
bombarding|bombard
boosting|boost
bossing|boss
botching|botch
boycotting|boycott
bracing|brace
bracketing|bracket
braiding|braid
brainwashing|brainwash
braising|braise
branding|brand
brandishing|brandish
braving|brave
breaching|breach
bribing|bribe
bricking|brick
bridging|bridge
briefing|brief
broaching|broach
brocading|brocade
bronzing|bronze
brooking|brook
browbeating|browbeat
brutalizing|brutalize
budgeting|budget
buffing|buff
bugging|bug
bulldozing|bulldoze
bunging|bung
bungling|bungle
buoying|buoy
burdening|burden
burlesquing|burlesque
burying|bury
busing|bus
bussing|bus
busying|busy
butchering|butcher
buttonholing|buttonhole
buttressing|buttress
by-passing|by-pass
bypassing|bypass
cajoling|cajole
calibrating|calibrate
camouflaging|camouflage
caning|cane
cannibalizing|cannibalize
canonizing|canonize
capping|cap
captivating|captivate
capturing|capture
carbonizing|carbonize
carding|card
caressing|caress
caricaturing|caricature
carpeting|carpet
casing|case
castigating|castigate
castrating|castrate
cataloguing|catalogue
catapulting|catapult
categorizing|categorize
ceding|cede
cementing|cement
censoring|censor
censuring|censure
centralizing|centralize
chagrining|chagrin
chaining|chain
chairing|chair
championing|champion
channelling|channel
chaperoning|chaperon
charming|charm
chartering|chart
charting|charter
chastening|chasten
chastising|chastise
cheapening|cheapen
checkmating|checkmate
cherishing|cherish
chiding|chide
chiselling|chisel
chlorinating|chlorinate
christening|christen
chronicling|chronicle
circularizing|circularize
circumcising|circumcise
circumnavigating|circumnavigate
circumscribing|circumscribe
circumventing|circumvent
citing|cite
civilizing|civilize
clamping|clamp
classifying|classify
clawing|claw
cleansing|cleanse
clenching|clench
clipping|clip
cloaking|cloak
clobbering|clobber
cloistering|cloister
cloning|clone
closeting|closet
clothing|clothe
clubbing|club
co-authoring|co-author
co-opting|co-opt
co-producing|co-produce
coating|coat
cobbling|cobble
cocking|cock
coddling|coddle
codifying|code
coding|codify
coercing|coerce
coining|coin
cold-shouldering|cold-shoulder
collaring|collar
collating|collate
collecting|collect
collectivizing|collectivize
colonizing|colonize
coloring|color
colouring|colour
combating|combat
combatting|combat
comforting|comfort
commandeering|commandeer
commemorating|commemorate
commending|commend
commercializing|commercialize
compacting|compact
compartmentalizing|compartmentalize
compiling|compile
complementing|complement
completing|complete
complicating|complicate
complimenting|compliment
composting|compost
compounding|compound
comprehending|comprehend
compressing|compress
comprising|comprise
computerizing|computerize
conning|con
concealing|conceal
concerning|concern
conciliating|conciliate
concocting|concoct
conditioning|condition
condoning|condone
configuring|configure
confining|confine
confiscating|confiscate
confounding|confound
confronting|confront
confusing|confuse
confuting|confute
congratulating|congratulate
conking|conk
connoting|connote
conquering|conquer
conscripting|conscript
consecrating|consecrate
conserving|conserve
consigning|consign
consoling|console
constituting|constitute
constraining|constrain
constricting|constrict
constructing|construct
construing|construe
consuming|consume
consummating|consummate
contacting|contact
containing|contain
contaminating|contaminate
contenting|content
contorting|contort
contouring|contour
contradicting|contradict
contravening|contravene
contriving|contrive
controlling|control
conveying|convey
convoking|convoke
convoying|convoy
convulsing|convulse
cooping|coop
coordinating|coordinate
copying|copy
copyrighting|copyright
cording|cord
cordoning|cordon
coring|core
corking|cork
cornering|corner
corralling|corral
correcting|correct
corroborating|corroborate
countenancing|countenance
counteracting|counteract
counterbalancing|counterbalance
counterfeiting|counterfeit
countermanding|countermand
countersigning|countersign
coupling|couple
courting|court
court-martialing|court-martial
coveting|covet
cradling|cradle
cramping|cramp
craning|crane
crayoning|crayon
creaming|cream
creating|create
crediting|credit
cremating|cremate
crimping|crimp
crippling|cripple
criticizing|criticize
cross-examining|cross-examine
cross-fertilizing|cross-fertilize
cross-indexing|cross-index
cross-questioning|cross-question
crossbreeding|crossbreed
crowning|crown
crucifying|crucify
crushing|crush
cubing|cube
cudgeling|cudgel
cuffing|cuff
culling|cull
cultivating|cultivate
cupping|cup
curbing|curb
curing|cure
currying|curry
curtailing|curtail
cushioning|cushion
damaging|damage
damning|damn
dampening|dampen
dandling|dandle
daubing|daub
daunting|daunt
dazing|daze
dazzling|dazzle
de-escalating|de-escalate
de-icing|de-ice
deadening|deaden
deafening|deafen
debarring|debar
debasing|debase
debauching|debauch
debilitating|debilitate
debiting|debit
debriefing|debrief
debugging|debug
debunking|debunk
decanting|decant
decapitating|decapitate
decarbonizing|decarbonize
deceiving|deceive
decentralizing|decentralize
decertifying|decertify
decimalizing|decimalize
decimating|decimate
deciphering|decipher
decking|deck
declaiming|declaim
declassifying|declassify
decoding|decode
decolonizing|decolonize
decompressing|decompress
decontaminating|decontaminate
decorating|decorate
decrying|decry
dedicating|dedicate
deducting|deduct
deep-freezing|deep-freeze
defacing|deface
defaming|defame
defeating|defeat
defending|defend
deferring|defer
defiling|defile
defining|define
deflating|deflate
deflowering|deflower
defoliating|defoliate
deforesting|deforest
deforming|deform
defrauding|defraud
defraying|defray
defrocking|defrock
defrosting|defrost
defusing|defuse
defying|defy
degrading|degrade
dehumanizing|dehumanize
dehydrating|dehydrate
deifying|deify
delegating|delegate
deleting|delete
delimiting|delimit
delineating|delineate
deluding|delude
demagnetizing|demagnetize
demarcating|demarcate
demeaning|demean
demilitarizing|demilitarize
demisting|demist
demobilizing|demobilize
demolishing|demolish
demoralizing|demoralize
demoting|demote
denationalizing|denationalize
denigrating|denigrate
denominating|denominate
denoting|denote
denouncing|denounce
denting|dent
denuding|denude
deodorizing|deodorize
depleting|deplete
deploring|deplore
deploying|deploy
depopulating|depopulate
deporting|deport
deposing|depose
depositing|deposit
deprecating|deprecate
deprogramming|deprogram
deranging|derange
deriding|deride
desalinating|desalinate
desalinizing|desalinize
desecrating|desecrate
desegregating|desegregate
desensitizing|desensitize
deserting|desert
desiccating|desiccate
designating|designate
despatching|despatch
despising|despise
despoiling|despoil
destroying|destroy
detaching|detach
detaining|detain
detecting|detect
deterring|deter
detesting|detest
dethroning|dethrone
devaluating|devaluate
devaluing|devalue
devastating|devastate
devising|devise
devoting|devote
devouring|devour
diagnosing|diagnose
dicing|dice
diddling|diddle
diffracting|diffract
dignifying|dignify
diluting|dilute
directing|direct
disabling|disable
disallowing|disallow
disappointing|disappoint
disarranging|disarrange
disassociating|disassociate
disavowing|disavow
disbursing|disburse
discarding|discard
disciplining|discipline
disclaiming|disclaim
discomfiting|discomfit
disconcerting|disconcert
disconnecting|disconnect
discontenting|discontent
discounting|discount
discouraging|discourage
discrediting|discredit
disdaining|disdain
disembarrassing|disembarrass
disembowelling|disembowel
disenchanting|disenchant
disenfranchising|disenfranchise
disestablishing|disestablish
disfavouring|disfavour
disfiguring|disfigure
disgorging|disgorge
disgracing|disgrace
disguising|disguise
disheartening|dishearten
dishonouring|dishonour
disillusioning|disillusion
disinfecting|disinfect
disinheriting|disinherit
disinterring|disinter
dislocating|dislocate
dislodging|dislodge
dismantling|dismantle
dismembering|dismember
dismissing|dismiss
disobeying|disobey
disorienting|disorient
disorientating|disorientate
disowning|disown
disparaging|disparage
dispatching|dispatch
dispelling|dispel
displacing|displace
displaying|display
displeasing|displease
dispossessing|dispossess
disproving|disprove
disqualifying|disqualify
disregarding|disregard
disrupting|disrupt
dissecting|dissect
disseminating|disseminate
dissociating|dissociate
dissuading|dissuade
distancing|distance
distilling|distil
distorting|distort
distracting|distract
distributing|distribute
distrusting|distrust
disturbing|disturb
ditching|ditch
diverting|divert
divesting|divest
divorcing|divorce
divulging|divulge
dizzying|dizzy
doctoring|doctor
documenting|document
doffing|doff
domesticating|domesticate
dominating|dominate
donating|don
donning|donate
dooming|doom
doping|dope
dotting|dot
double-checking|double-check
double-crossing|double-cross
dousing|douse
downgrading|down
downing|downgrade
downloading|download
dragooning|dragoon
dramatizing|dramatize
draping|drape
drenching|drench
drip-drying|drip-dry
drubbing|drub
drugging|drug
dry-cleaning|dry-clean
dumbfounding|dumbfound
dunking|dunk
duping|dupe
duplicating|duplicate
dusting|dust
dwarfing|dwarf
dyeing|dye
dynamiting|dynamite
earmarking|earmark
earning|earn
eclipsing|eclipse
edifying|edify
editing|edit
effacing|efface
effecting|effect
elbowing|elbow
electrifying|electrify
electrocuting|electrocute
elevating|elevate
eliciting|elicit
eliding|elide
eliminating|eliminate
elucidating|elucidate
eluding|elude
emancipating|emancipate
emasculating|emasculate
embalming|embalm
embargoing|embargo
embedding|embed
embellishing|embellish
embezzling|embezzle
embittering|embitter
emblazoning|emblazon
embodying|embody
emboldening|embolden
embossing|emboss
embracing|embrace
embroiling|embroil
emending|emend
emitting|emit
empanelling|empanel
empowering|empower
emulating|emulate
emulsifying|emulsify
enacting|enact
enamelling|enamel
encasing|encase
enchanting|enchant
encircling|encircle
enclosing|enclose
encoding|encode
encompassing|encompass
encountering|encounter
encrypting|encrypt
encumbering|encumber
endangering|endanger
endearing|endear
endorsing|endorse
endowing|endow
enervating|enervate
enfolding|enfold
enforcing|enforce
enfranchising|enfranchise
engendering|engender
engineering|engineer
engraving|engrave
engrossing|engross
engulfing|engulf
enhancing|enhance
enjoining|enjoin
enlarging|enlarge
enlightening|enlighten
enlivening|enliven
enmeshing|enmesh
ennobling|ennoble
enraging|enrage
enriching|enrich
ensconcing|ensconce
enshrining|enshrine
enshrouding|enshroud
enslaving|enslave
ensnaring|ensnare
entangling|entangle
enthralling|enthral
enthralling|enthrall
enthroning|enthrone
entombing|entomb
entraining|entrain
entrancing|entrance
entrapping|entrap
entreating|entreat
entrusting|entrust
entwining|entwine
enumerating|enumerate
enveloping|envelop
envisaging|envisage
envying|envy
epitomizing|epitomize
equalizing|equal
equalling|equalize
equating|equate
equipping|equip
eradicating|eradicate
erasing|erase
erecting|erect
eschewing|eschew
escorting|escort
espousing|espouse
espying|espy
establishing|establish
esteeming|esteem
eulogizing|eulogize
evading|evade
evaluating|evaluate
evicting|evict
evincing|evince
eviscerating|eviscerate
evoking|evoke
exacerbating|exacerbate
exalting|exalt
examining|examine
exasperating|exasperate
excavating|excavate
exceeding|exceed
excepting|except
exchanging|exchange
excising|excise
excluding|exclude
excommunicating|excommunicate
excoriating|excoriate
excreting|excrete
exculpating|exculpate
excusing|excuse
executing|execute
exemplifying|exemplify
exempting|exempt
exerting|exert
exhausting|exhaust
exhibiting|exhibit
exhilarating|exhilarate
exhuming|exhume
exiling|exile
exorcizing|exorcize
expediting|expedite
expelling|expel
expending|expend
experiencing|experience
expiating|expiate
explicating|explicate
exploiting|exploit
exporting|export
exposing|expose
expressing|express
expropriating|expropriate
expunging|expunge
expurgating|expurgate
extenuating|extenuate
exterminating|exterminate
externalizing|externalize
extinguishing|extinguish
extirpating|extirpate
extolling|extol
extorting|extort
extracting|extract
extraditing|extradite
extricating|extricate
exuding|exude
eying|eye
fabricating|fabricate
facilitating|facilitate
fagging|fag
faking|fake
falsifying|falsify
familiarizing|familiarize
fancying|fancy
fascinating|fascinate
fashioning|fashion
fating|fate
fathoming|fathom
fatiguing|fatigue
faulting|fault
favouring|favour
feathering|feather
featuring|feature
feeding|feed
feigning|feign
felling|fell
fencing|fence
ferreting|ferret
fertilizing|fertilize
festooning|festoon
feting|fete
fettering|fetter
filleting|fillet
finalizing|finalize
financing|finance
fine-tuning|fine-tune
fingering|finger
flagellating|flagellate
flanking|flank
flattering|flatter
flaunting|flaunt
flavouring|flavour
flaying|flay
fleecing|fleece
flexing|flex
flicking|flick
flogging|flog
floodlighting|floodlight
flooring|floor
flouting|flout
fluffing|fluff
flummoxing|flummox
fluoridating|fluoridate
flurrying|flurry
flustering|fluster
foiling|foil
foisting|foist
fomenting|foment
fondling|fondle
fooling|fool
force-feeding|force-feed
fording|ford
forecasting|forecast
foregoing|forego
foreordaining|foreordain
foreshadowing|foreshadow
foreshortening|foreshorten
forestalling|forestall
foreswearing|foreswear
foretelling|foretell
forfeiting|forfeit
forging|forge
forgoing|forgo
formalizing|formalize
formulating|formulate
forsaking|forsake
forswearing|forswear
fortifying|fortify
forwarding|forward
fostering|foster
founding|found
framing|frame
franking|frank
freeing|free
frequenting|frequent
frescoing|fresco
fricasseeing|fricassee
frightening|frighten
frisking|frisk
frittering|fritter
frogmarching|frogmarch
frustrating|frustrate
frying|fry
fulfilling|fulfil
fulfilling|fulfill
fumigating|fumigate
funding|fund
funnelling|funnel
furbishing|furbish
furnishing|furnish
furrowing|furrow
furthering|further
gaging|gage
gainsaying|gainsay
galling|gall
galvanizing|galvanize
gaoling|gaol
garbing|garb
garbling|garble
garnering|garner
garnishing|garnish
garrisoning|garrison
gashing|gash
gatecrashing|gatecrash
gauging|gauge
generating|generate
gerrymandering|gerrymander
gilding|gild
ginning|gin
girding|gird
gladdening|gladden
glamorizing|glamorize
gleaning|glean
glimpsing|glimpse
glorifying|glorify
glutting|glut
goading|goad
gorging|gore
goring|gorge
grabbing|grab
gracing|grace
grading|grade
grafting|graft
gratifying|gratify
gravelling|gravel
greasing|grease
greeting|greet
grilling|grill
gripping|grip
gritting|grit
groining|groin
grooming|groom
grossing|gross
grudging|grudge
guarding|guard
guiding|guide
guillotining|guillotine
gumming|gum
gunning|gun
gutting|gut
guzzling|guzzle
gypping|gyp
hallowing|hallow
halting|halt
halving|halve
hampering|hamper
hamstringing|hamstring
handcuffing|handcuff
handicapping|handicap
handling|handle
haranguing|harangue
harassing|harass
harboring|harbor
harbouring|harbour
harming|harm
harnessing|harness
harpooning|harpoon
harrowing|harrow
harrying|harry
harvesting|harvest
hassling|hassle
haunting|haunt
hawking|hawk
hazarding|hazard
hazing|haze
heaping|heap
heartening|hearten
heeding|heed
heralding|herald
highjacking|highjack
highlighting|highlight
hijacking|hijack
hindering|hinder
hitting|hit
hoaxing|hoax
hobbling|hobble
hocking|hock
hogging|hog
hollowing|hollow
homogenizing|homogenize
honing|hone
honoring|honor
honouring|honour
hooding|hood
hoodwinking|hoodwink
horrifying|horrify
horsewhipping|horsewhip
hosing|hose
hospitalizing|hospitalize
hosting|host
hotfooting|hotfoot
hounding|hound
housing|house
hulling|hull
humbling|humble
humbugging|humbug
humiliating|humiliate
humouring|humour
humping|hump
hunching|hunch
hurling|hurl
husking|husk
hyphenating|hyphenate
hypnotizing|hypnotize
idealizing|idealize
identifying|identify
idolizing|idolize
ignoring|ignore
ill-treating|ill-treat
illuminating|illuminate
illumining|illumine
illustrating|illustrate
imaging|image
imbibing|imbibe
imbuing|imbue
imitating|imitate
immersing|immerse
immobilizing|immobilize
immolating|immolate
immortalizing|immortalize
immunizing|immunize
impacting|impact
impairing|impair
impaling|impale
impanelling|impanel
imparting|impart
impeaching|impeach
impeding|impede
imperilling|imperil
impersonating|impersonate
implanting|implant
implementing|implement
implicating|implicate
importing|import
imposing|impose
impounding|impound
impoverishing|impoverish
impregnating|impregnate
impressing|impress
imprinting|imprint
imprisoning|imprison
impugning|impugn
imputing|impute
inactivating|inactivate
inaugurating|inaugurate
incapacitating|incapacitate
incarcerating|incarcerate
incensing|incense
incinerating|incinerate
including|include
inconveniencing|inconvenience
incriminating|incriminate
inculcating|inculcate
incurring|incur
indemnifying|indemnify
indenturing|indenture
indexing|index
indicting|indict
individuating|individuate
indoctrinating|indoctrinate
inducting|induct
infatuating|infatuate
infecting|infect
infesting|infest
infiltrating|infiltrate
inflaming|inflame
inflating|inflate
inflecting|inflect
inflicting|inflict
influencing|influence
infuriating|infuriate
infusing|infuse
ingesting|ingest
ingratiating|ingratiate
inhabiting|inhabit
inheriting|inherit
inhibiting|inhibit
initialling|initial
initiating|initiate
injecting|inject
injuring|injure
inking|ink
inoculating|inoculate
inscribing|inscribe
inseminating|inseminate
inserting|insert
inspecting|inspect
installing|install
instigating|instigate
instilling|instil
instilling|instill
instituting|institute
institutionalizing|institutionalize
insulating|insulate
insulting|insult
insuring|insure
integrating|integrate
interring|inter
intercepting|intercept
interchanging|interchange
interdicting|interdict
interesting|interest
interjecting|interject
interleaving|interleave
internalizing|internalize
internationalizing|internationalize
interpolating|interpolate
interrogating|interrogate
interspersing|intersperse
interweaving|interweave
intimidating|intimidate
intoning|intone
intoxicating|intoxicate
introducing|introduce
intuiting|intuit
inundating|inundate
invading|invade
invalidating|invalidate
inveigling|inveigle
inventing|invent
inverting|invert
invigorating|invigorate
invoking|invoke
irking|irk
irradiating|irradiate
irrigating|irrigate
isolating|isolate
italicizing|italicize
itemizing|itemize
iterating|iterate
jailing|jail
jarring|jar
jeopardizing|jeopardize
jettisoning|jettison
jilting|jilt
jollying|jolly
jugging|jug
juxtaposing|juxtapose
kenning|ken
kidnapping|kidnap
kissing|kiss
kneading|knead
knifing|knife
knighting|knight
labelling|label
lacerating|lace
lacing|lacerate
lacking|lack
lacquering|lacquer
lambasting|lambaste
laminating|laminate
lampooning|lampoon
lancing|lance
landscaping|landscape
lassoing|lasso
lauding|laud
laundering|launder
lavishing|lavish
leaching|leach
leapfrogging|leapfrog
leasing|lease
leavening|leaven
legalizing|legalize
legitimatizing|legitimatize
levering|lever
leveraging|leverage
levying|levy
libelling|libel
liberalizing|liberalize
liberating|liberate
licencing|licence
likening|liken
limiting|limit
lionizing|lionize
liquidizing|liquidize
listing|list
loaning|loan
loathing|loathe
lobbing|lob
localizing|localize
lofting|loft
looting|loot
lubricating|lubricate
lugging|lug
lulling|lull
lumping|lump
luring|lure
lynching|lynch
maddening|madden
magnetizing|magnetize
magnifying|magnify
maiming|maim
maligning|malign
maltreating|maltreat
manning|man
manacling|manacle
mandating|mandate
mangling|mangle
manhandling|manhandle
manicuring|manicure
manifesting|manifest
manipulating|manipulate
manufacturing|manufacture
marring|mar
marketing|market
marooning|maroon
marshalling|marshal
martyring|martyr
mashing|mash
masking|mask
mass-producing|mass-produce
massaging|massage
mastering|master
masterminding|mastermind
masticating|masticate
mauling|maul
maximizing|maximize
measuring|measure
mechanizing|mechanize
medicating|medicate
memorializing|memorialize
memorizing|memorize
menacing|menace
meriting|merit
mesmerizing|mesmerize
microfilming|microfilm
milking|milk
mimeographing|mimeograph
mimicking|mimic
mincing|mince
miniaturizing|miniaturize
minimizing|minimize
minting|mint
miring|mire
mirroring|mirror
misapplying|misapply
misapprehending|misapprehend
misappropriating|misappropriate
miscastting|miscast
misconceiving|misconceive
misconstruing|misconstrue
misdating|misdate
misdirecting|misdirect
misgoverning|misgovern
misguiding|misguide
mishandling|mishandle
mishearing|mishear
misinforming|misinform
misinterpreting|misinterpret
mislaying|mislay
misleading|mislead
mismanaging|mismanage
misnaming|misname
misplacing|misplace
mispronouncing|mispronounce
misquoting|misquote
misreading|misread
misrepresenting|misrepresent
misspelling|misspell
misspending|misspend
misstating|misstate
mistaking|mistake
mistranslating|mistranslate
mistreating|mistreat
mistrusting|mistrust
misusing|misuse
mitigating|mitigate
mobbing|mob
mocking|mock
modeling|model
modifying|modify
modulating|modulate
molding|mold
molesting|molest
mollifying|mollify
mollycoddling|mollycoddle
monitoring|monitor
monopolizing|monopolize
mooring|moor
mortaring|mortar
mortgaging|mortgage
mortifying|mortify
mothproofing|mothproof
motorizing|motorize
muddying|muddy
muffing|muff
muffling|muffle
mugging|mug
mulching|mulch
murdering|murder
mustering|muster
mutilating|mute
muting|mutilate
muzzling|muzzle
mystifying|mystify
nabbing|nab
nagging|nag
narrating|narrate
nationalizing|nationalize
naturalizing|naturalize
needling|needle
negating|negate
netting|net
nettling|nettle
neutering|neuter
neutralizing|neutralize
nicking|nick
nicknaming|nickname
normalizing|normalize
nourishing|nourish
nudging|nudge
nullifying|nullify
numbering|numb
numbing|number
nursing|nurse
nurturing|nurture
obfuscating|obfuscate
obligating|obligate
obliterating|obliterate
obscuring|obscure
obstructing|obstruct
obtaining|obtain
obviating|obviate
occasioning|occasion
occupying|occupy
offending|offend
offsetting|offset
oiling|oil
okaying|okay
omening|omen
omitting|omit
oppressing|oppress
orchestrating|orchestrate
ordaining|ordain
organizing|organize
orienting|orient
orientating|orientate
ornamenting|ornament
ostracizing|ostracize
ousting|oust
outbalancing|outbalance
outbiding|outbid
outclassing|outclass
outdistancing|outdistance
outdoing|outdo
outfighting|outfight
outfitting|outfit
outflanking|outflank
outfoxing|outfox
outgrowing|outgrow
outlasting|outlast
outlawing|outlaw
outlining|outline
outliving|outlive
outmanoeuvring|outmanoeuvre
outnumbering|outnumber
outplaying|outplay
outraging|outrage
outranking|outrank
outriding|outride
outrunning|outrun
outshining|outshine
outsmarting|outsmart
outstaying|outstay
outvoting|outvote
outweighing|outweigh
outwitting|outwit
overawing|overawe
overbearing|overbear
overburdening|overburden
overcooking|overcook
overcoming|overcome
overcrowding|overcrowd
overdoing|overdo
overemphasizing|overemphasize
overestimating|overestimate
overexerting|overexert
overexposing|overexpose
overhauling|overhaul
overhearing|overhear
overleaping|overleap
overloading|overload
overlooking|overlook
overpaying|overpay
overplaying|overplay
overpowering|overpower
overpraising|overpraise
overprinting|overprint
overrating|overrate
overriding|override
overruling|overrule
overrunning|overrun
overseeing|oversee
overshadowing|overshadow
overshooting|overshoot
oversimplifying|oversimplify
overstating|overstate
overstaying|overstay
overstepping|overstep
overstocking|overstock
overstraining|overstrain
overtaking|overtake
overtaxing|overtax
overvaluing|overvalue
overwhelming|overwhelm
owning|own
oxygenating|oxygenate
pacifying|pacify
packaging|package
padding|pad
padlocking|padlock
paging|page
paining|pain
pampering|pamper
papering|paper
parallelling|parallel
paralysing|paralyse
paralyzing|paralyze
paraphrasing|paraphrase
parching|parch
pardoning|pardon
paring|pare
parodying|parody
paroling|parole
parrying|parry
parsing|parse
partitioning|partition
partnering|partner
pasteurizing|paste
pasting|pasteurize
patting|pat
patenting|patent
patrolling|patrol
patronizing|patronize
patterning|pattern
pauperizing|pauperize
pawing|paw
pawning|pawn
pegging|peg
pelting|pelt
penalizing|penalize
pencilling|pencil
peppering|pepper
perfecting|perfect
perforating|perforate
perfuming|perfume
perfusing|perfuse
perjuring|perjure
perming|perm
permeating|permeate
permuting|permute
perpetrating|perpetrate
perpetuating|perpetuate
perplexing|perplex
persecuting|persecute
personalizing|personalize
personifying|personify
perturbing|perturb
perusing|peruse
pervading|pervade
perverting|pervert
pestering|pester
petting|pet
photocopying|photocopy
photographing|photograph
photosensitizing|photosensitize
photostatting|photostat
phrasing|phrase
pickling|pickle
picturing|picture
piercing|pierce
pigeonholing|pigeonhole
pilfering|pilfer
piloting|pilot
pinching|pinch
pinpointing|pinpoint
piping|pip
pipping|pipe
piquing|pique
pirating|pirate
pitting|pit
pitchforking|pitchfork
pitying|pity
placating|placate
placing|place
plagiarizing|plagiarize
plaguing|plague
planting|plant
plastering|plaster
pleasing|please
plying|ply
plumbing|plumb
pocketing|pocket
poisoning|poison
polarizing|polarize
policing|police
polishing|polish
politicizing|politicize
pollinating|pollinate
polluting|pollute
pondering|ponder
pooh-poohing|pooh-pooh
pooling|pool
popularizing|popularize
populating|populate
porting|port
portending|portend
positioning|position
possessing|possess
posting|post
postdating|postdate
postmarking|postmark
postponing|postpone
powdering|powder
praising|praise
pre-empting|pre-empt
prearranging|prearrange
preceding|precede
precipitating|precipitate
precluding|preclude
preconceiving|preconceive
predestining|predestine
predetermining|predetermine
predicating|predicate
predisposing|predispose
preempting|preempt
preening|preen
prefabricating|prefabricate
prefacing|preface
prefiguring|prefigure
preheating|preheat
prejudging|prejudge
prejudicing|prejudice
premeditating|premeditate
premising|premise
preoccupying|preoccupy
preordaining|preordain
prepaying|prepay
prerecording|prerecord
presaging|presage
prescribing|prescribe
presenting|present
preserving|preserve
presorting|presort
pressurizing|pressurize
prettifying|prettify
preventing|prevent
pricing|price
priding|pride
priming|prime
printing|print
privileging|privilege
prizing|prize
probing|probe
processing|process
procuring|procure
prodding|prod
producing|produce
proffering|proffer
profiling|profile
prognosticating|prognosticate
prohibiting|prohibit
projecting|project
prolonging|prolong
promoting|promote
promulgating|promulgate
pronouncing|pronounce
proofing|proof
propelling|propel
proportioning|proportion
propositioning|proposition
propounding|propound
proscribing|proscribe
prosecuting|prosecute
prostituting|prostitute
prostrating|prostrate
protecting|protect
pruning|prune
psychoanalysing|psychoanalyse
psychoanalyzing|psychoanalyze
publicizing|publicize
publishing|publish
pulverizing|pulverize
pummelling|pummel
punctuating|punctuate
punishing|punish
purchasing|purchase
purifying|purify
purloining|purloin
pursing|purse
pursuing|pursue
purveying|purvey
quaffing|quaff
qualifying|qualify
quantifying|quantify
quarantining|quarantine
quartering|quarter
quashing|quash
quelling|quell
quenching|quench
querying|query
questioning|question
quick-freezing|quick-freeze
quilting|quilt
quoting|quote
raffling|raffle
raiding|raid
railroading|railroad
ramming|ram
ramping|ramp
ransacking|ransack
ransoming|ransom
raping|rape
ratifying|ratify
rationing|ration
rationalizing|rationalize
ravaging|ravage
ravishing|ravish
razing|raze
re-addressing|re-address
re-educating|re-educate
re-establishing|re-establish
readmitting|readmit
reaping|reap
rearranging|rearrange
reassessing|reassess
reauthorizing|reauthorize
rebuffing|rebuff
rebuking|rebuke
rebutting|rebut
recapturing|recapture
recasting|recast
recessing|recess
reciting|recite
reclaiming|reclaim
recommitting|recommit
recompensing|recompense
reconciling|reconcile
reconditioning|recondition
reconsecrating|reconsecrate
reconsidering|reconsider
reconstructing|reconstruct
reconvicting|reconvict
recouping|recoup
recreating|recreate
rectifying|rectify
recycling|recycle
redecorating|redecorate
redeeming|redeem
redefining|redefine
redeploying|redeploy
redesigning|redesign
redeveloping|redevelop
rediscovering|rediscover
redistributing|redistribute
redoing|redo
redressing|redress
reducing|reduce
reduplicating|reduplicate
reestablishing|reestablish
refashioning|refashion
refilling|refill
refinancing|refinance
refining|refine
reformulating|reformulate
refracting|refract
refreshing|refresh
refrigerating|refrigerate
refunding|refund
refurbishing|refurbish
refurnishing|refurnish
refuting|refute
regaining|regain
regaling|regale
regimenting|regiment
regularizing|regularize
regulating|regulate
regurgitating|regurgitate
rehabilitating|rehabilitate
rehashing|rehash
rehousing|rehouse
reimbursing|reimburse
reinforcing|reinforce
reinstating|reinstate
reinsuring|reinsure
reintegrating|reintegrate
reinterpreting|reinterpret
reinventing|reinvent
reissuing|reissue
rejecting|reject
rejoining|rejoin
rejuvenating|rejuvenate
relaying|relay
releasing|release
relegating|relegate
relieving|relieve
relinquishing|relinquish
relishing|relish
relisting|relist
reliving|relive
remanding|remand
remedying|remedy
remilitarizing|remilitarize
remodelling|remodel
remoulding|remould
removing|remove
remunerating|remunerate
rending|rend
renewing|renew
renouncing|renounce
renovating|renovate
reorienting|reorient
reorientating|reorientate
repackaging|repackage
repainting|repaint
repatriating|repatriate
repealing|repeal
repelling|repel
replacing|replace
replanting|replant
replaying|replay
replenishing|replenish
replicating|replicate
reprehending|reprehend
representing|represent
repressing|repress
reprieving|reprieve
reprimanding|reprimand
reprinting|reprint
reproaching|reproach
reproofing|reproof
reproving|reprove
repudiating|repudiate
repulsing|repulse
repurchasing|repurchase
reputing|repute
requisitioning|requisition
rereading|reread
rerouting|reroute
rescheduling|reschedule
rescinding|rescind
rescuing|rescue
researching|research
reseating|reseat
reselling|resell
resembling|resemble
resenting|resent
reserving|reserve
resetting|reset
reshaping|reshape
reshuffling|reshuffle
resoling|resole
respecting|respect
restating|restate
restocking|restock
restoring|restore
restraining|restrain
restricting|restrict
restructuring|restructure
resuming|resume
resurrecting|resurrect
retaining|retain
retaking|retake
retarding|retard
retelling|retell
rethinking|rethink
retouching|retouch
retracing|retrace
retracting|retract
retransmitting|retransmit
retrieving|retrieve
revaluing|revalue
revamping|revamp
revering|revere
reviewing|review
reviling|revile
revising|revise
revisiting|revisit
revitalizing|revitalize
revoking|revoke
revolutionizing|revolutionize
rewarding|reward
rewiring|rewire
rewording|reword
rewriting|rewrite
ribbing|rib
riddling|riddle
ridiculing|ridicule
rifling|rifle
righting|right
rimming|rim
rivaling|rival
rivalling|rival
riveting|rivet
romanticizing|romanticize
roping|rope
routing|rout
routing|route
rubber-stamping|rubber-stamp
rubberizing|rubberize
ruing|rue
ruining|ruin
rumpling|rumple
rusticating|rusticate
sabotaging|sabotage
sacking|sack
saddening|sadden
saddling|saddle
safeguarding|safeguard
salting|salt
salvaging|salvage
sampling|sample
sanctifying|sanctify
sanctioning|sanction
sanding|sand
sandblasting|sandblast
sandpapering|sandpaper
sandwiching|sandwich
sapping|sap
satiating|satiate
satirizing|satirize
satisfying|satisfy
saturating|saturate
sauteing|saute
savaging|savage
savouring|savour
scalding|scald
scalping|scalp
scandalizing|scandalize
scanting|scant
scarring|scar
scenting|scent
scheduling|schedule
schooling|school
scooping|scoop
scorching|scorch
scorning|scorn
scotching|scotch
scouring|scour
scrapping|scrap
screening|screen
scrunching|scrunch
scrutinizing|scrutinize
sculpting|sculpt
scuttling|scuttle
searing|sear
seasoning|season
seating|seat
seconding|second
secreting|secrete
secularizing|secularize
securing|secure
sedating|sedate
seducing|seduce
seeding|seed
segregating|segregate
selecting|select
sensitizing|sensitize
sentimentalizing|sentimentalize
sequestering|sequester
serenading|serenade
serializing|serialize
servicing|service
shackling|shackle
shadowing|shadow
shaming|shame
shampooing|shampoo
sharing|share
sharpening|sharpen
shearing|shear
sheathing|sheathe
sheltering|shelter
shedding|shed
shelving|shelve
shepherding|shepherd
shielding|shield
shingling|shingle
shirking|shirk
shocking|shock
shooing|shoo
short-changing|short-change
shortlisting|shortlist
shouldering|shoulder
shovelling|shovel
shredding|shred
shrouding|shroud
shucking|shuck
shunning|shun
shunting|shunt
shuttering|shutter
sicking|sick
sickening|sicken
sidelining|sideline
sidestepping|sidestep
sidetracking|sidetrack
sieving|sieve
sighting|sight
signposting|signpost
silencing|silence
silhouetting|silhouette
simplifying|simplify
simulating|simulate
siphoning|siphon
siring|sire
skewering|skewer
skinning|skin
skippering|skipper
skirting|skirt
slaking|slake
slandering|slander
slapping|slap
slashing|slash
slating|slate
slaughtering|slaughter
slaying|slay
slicing|slice
slighting|slight
slinging|sling
slotting|slot
slugging|slug
slurring|slur
smelting|smelt
smiting|smite
smothering|smother
snagging|snag
snaring|snare
snubbing|snub
socking|sock
soft-pedalling|soft-pedal
soiling|soil
soldering|solder
soliciting|solicit
solving|solve
soothing|soothe
soundproofing|soundproof
souping|soup
sousing|souse
spading|spade
spanning|span
spanking|spank
sparing|spare
spaying|spay
spearing|spear
spearheading|spearhead
specifying|specify
spewing|spew
spiking|spike
spin-drying|spin-dry
spiriting|spirit
spiting|spite
splicing|splice
sponsoring|sponsor
spoonfeeding|spoonfeed
spotting|spot
spotlighting|spotlight
spraining|sprain
spraying|spray
sprinkling|sprinkle
spurning|spurn
squandering|squander
squelching|squelch
squiring|squire
stabbing|stab
staffing|staff
staging|stage
stalemating|stalemate
standardizing|standardize
stapling|staple
starching|starch
startling|startle
stashing|stash
stationing|station
staunching|staunch
stealing|steal
steamrollering|steamroller
steeling|steel
stereotyping|stereotype
sterilizing|sterilize
stiffing|stiff
stigmatizing|stigmatize
stilling|still
stimulating|stimulate
stitching|stitch
stockading|stockade
stoking|stoke
stomaching|stomach
stoning|stone
storing|store
stowing|stow
straddling|straddle
strafing|strafe
straitening|straiten
strangling|strangle
strapping|strap
streamlining|streamline
strewing|strew
stroking|stroke
structuring|structure
stubbing|stub
stuccoing|stucco
studding|stud
stunning|stun
stunting|stunt
styling|style
stylizing|stylize
stymieing|stymie
subduing|subdue
subediting|subedit
subjecting|subject
subjugating|subjugate
sublimating|sublimate
subordinating|subordinate
subpoenaing|subpoena
subserving|subserve
subsidizing|subsidize
substantiating|substantiate
subsuming|subsume
subtending|subtend
subtracting|subtract
subverting|subvert
succouring|succour
suckling|suckle
suffusing|suffuse
suiting|suit
sullying|sully
summarizing|summarize
summoning|summon
sunning|sun
sundering|sunder
superimposing|superimpose
superseding|supersede
supplanting|supplant
supplementing|supplement
supplying|supply
supporting|support
suppressing|suppress
surmounting|surmount
surpassing|surpass
surrounding|surround
surveying|survey
suspending|suspend
sustaining|sustain
swamping|swamp
swathing|swat
swatting|swathe
sweetening|sweeten
swigging|swig
swindling|swindle
swiping|swipe
symbolizing|symbolize
syncopating|syncopate
syndicating|syndicate
synthesizing|synthesize
syphoning|syphon
systematizing|systematize
tabling|table
tabulating|tabulate
tailing|tail
tailoring|tailor
tainting|taint
taming|tame
tamping|tamp
tantalizing|tantalize
tarring|tar
targeting|target
tattooing|tattoo
taunting|taunt
taxing|tax
teasing|tease
telecasting|telecast
telescoping|telescope
televising|televise
tendering|tender
terracing|terrace
terrifying|terrify
terrorizing|terrorize
testing|test
test-driving|test-drive
tethering|tether
thanking|thank
thatching|thatch
thirsting|thirst
threading|thread
thumbing|thumb
thwarting|thwart
ticketing|ticket
tiling|tile
tilling|till
timing|time
tinting|tint
titillating|titillate
toeing|toe
tolerating|tolerate
tormenting|torment
torpedoing|torpedo
torturing|torture
toting|tote
touring|tour
tousling|tousle
touting|tout
towing|tow
towelling|towel
trampling|trample
tranquilizing|tranquilize
tranquillizing|tranquillize
transacting|transact
transcending|transcend
transcribing|transcribe
transfixing|transfix
transforming|transform
transfusing|transfuse
transmitting|transmit
transmuting|transmute
transporting|transport
transposing|transpose
transshipping|transship
trapping|trap
traversing|traverse
treasuring|treasure
tricking|trick
triggering|trigger
trivializing|trivialize
troubling|trouble
trouncing|trounce
truncating|truncate
tutoring|tutor
tweaking|tweak
twiddling|twiddle
typecasting|typecast
typifying|typify
tyrannizing|tyrannize
unbalancing|unbalance
unbanning|unban
unblocking|unblock
unbolting|unbolt
unbuckling|unbuckle
unburdening|unburden
unbuttoning|unbutton
uncorking|uncork
uncoupling|uncouple
uncovering|uncover
uncrossing|uncross
undercharging|undercharge
undercutting|undercut
underestimating|underestimate
underexposing|underexpose
undergoing|undergo
underlining|underlie
underlying|underline
undermining|undermine
underpaying|underpay
underpinning|underpin
underquoting|underquote
underrating|underrate
underscoring|underscore
underselling|undersell
undershooting|undershoot
undersigning|undersign
understating|understate
understocking|understock
understudying|understudy
undervaluing|undervalue
underwriteing|underwrite
undoing|undo
unearthing|unearth
unfettering|unfetter
unfrocking|unfrock
unfurling|unfurl
unhanding|unhand
unhinging|unhinge
unhooking|unhook
unlearning|unlearn
unleashing|unleash
unloosing|unloose
unmasking|unmask
unnerving|unnerve
unplugging|unplug
unsaddling|unsaddle
unscrambling|unscramble
unsettling|unsettle
unsheathing|unsheathe
unveiling|unveil
unzipping|unzip
upbraiding|upbraid
updating|update
upgrading|upgrade
upholding|uphold
upholstering|upholster
uplifting|uplift
uprooting|uproot
upsetting|upset
upstaging|upstage
ushering|usher
usurping|usurp
utilizing|utilize
uttering|utter
vacating|vacate
vaccinating|vaccinate
valeting|valet
validating|validate
valuing|value
vanquishing|vanquish
varnishing|varnish
veiling|veil
vending|vend
venerating|venerate
venting|vent
ventilating|ventilate
verbalizing|verbalize
vetoing|vet
vetting|veto
vexing|vex
victimizing|victimize
videotaping|videotape
vilifying|vilify
vindicating|vindicate
violating|violate
visaing|visa
visualizing|visualize
vitiating|vitiate
vivisecting|vivisect
vocalizing|vocalize
voicing|voice
voiding|void
vouchsafing|vouchsafe
vulgarizing|vulgarize
waging|wage
waiving|waive
walling|wall
walloping|wallop
wangling|wangle
warding|ward
warranting|warrant
wasting|waste
waterproofing|waterproof
waylaying|waylay
weaning|wean
weathering|weather
wedging|wedge
weighting|weight
welcoming|welcome
wending|wend
westernizing|westernize
wetting|wet
whacking|whack
wheedling|wheedle
whetting|whet
whiling|while
whitewashing|whitewash
wielding|wield
winging|wing
winnowing|winnow
withholding|withhold
withstanding|withstand
witnessing|witness
wolfing|wolf
wooing|woo
wording|word
worming|worm
wounding|wound
wreaking|wreak
wrecking|wreck
wrenching|wrench
wresting|wrest
wronging|wrong
zapping|zap
zoning|zone
barging|barge
boozing|booze
bottoming|bottom
bowing|bow
branching|branch
breezing|breeze
brimming|brim
bulging|bulge
caving|cave
clamming|clam
clicking|click
clowning|clown
coming|come
crapping|crap
crawling|crawl
creeping|creep
cropping|crop
crouching|crouch
cruising|cruise
crying|cry
dancing|dance
darting|dart
diving|dive
dozing|doze
drifting|drift
droning|drone
fading|fade
fizzling|fizzle
flocking|flock
flowing|flow
foaming|foam
forking|fork
ganging|gang
gearing|gear
goofing|goof
gushing|gush
hurrying|hurry
jogging|jog
jutting|jut
keeling|keel
kneeling|kneel
kneeling|kneel
knuckling|knuckle
lying|lie
limping|limp
lingering|linger
listening|listen
looming|loom
lunging|lunge
lurching|lurch
marching|march
mellowing|mellow
nestling|nestle
opting|opt
peeking|peek
peering|peer
perking|perk
petering|peter
pigging|pig
pining|pine
plonking|plonk
plopping|plop
puffing|puff
rotting|rot
sailing|sail
sallying|sally
sitting|sit
screaming|scream
scurrying|scurry
seeping|seep
shacking|shack
shining|shine
shining|shine
shopping|shop
shriveling|shrivel
shying|shy
slacking|slack
slaving|slave
sliding|slide
slimming|slim
slinking|slink
sloping|slope
slumping|slump
soaring|soar
soldiering|soldier
spurting|spurt
squatting|squat
standing|stand
stepping|step
stooping|stoop
streaming|stream
strolling|stroll
strutting|strut
stumbling|stumble
swimming|swim
swooping|swoop
teaming|team
tensing|tense
toddling|toddle
tramping|tramp
trickling|trickle
trudging|trudge
tumbling|tumble
veering|veer
wafting|waft
walking|walk
zeroing|zero
zooming|zoom
skidding|skid
averaging|average
backing|back
bailing|bail
banging|bang
beaming|beam
beating|beat
beefing|beef
bellowing|bellow
bending|bend
binding|bind
blaring|blare
bobbing|bob
bogging|bog
boiling|boil
bolting|bolt
boring|bore
bouncing|bounce
bounding|bound
bowling|bowl
boxing|box
breaking|break
breathing|breathe
brightening|brighten
bruising|bruise
brushing|brush
bucking|buck
buckling|buckle
building|build
bumming|bum
bumping|bump
bunching|bunch
burning|burn
busting|bust
butting|butt
buttoning|button
buzzing|buzz
calming|calm
camping|camp
canceling|cancel
carving|carve
cashing|cash
casting|cast
catching|catch
changing|change
chatting|chat
cheating|cheat
checking|check
cheering|cheer
chewing|chew
chilling|chill
chipping|chip
choking|choke
chopping|chop
churning|churn
climbing|climb
clogging|clog
closing|close
clouding|cloud
clumping|clump
coiling|coil
combing|comb
connecting|connect
contracting|contract
cooking|cook
cooling|cool
copping|cop
coughing|cough
counting|count
cracking|crack
cramming|cram
crossing|cross
crowding|crowd
crumbling|crumble
crumpling|crumple
crunching|crunch
curling|curl
dashing|dash
deal|dealing
dialing|dial
digging|dig
dining|dine
dragging|drag
draining|drain
drawing|draw
dressing|dress
driving|drive
dropping|drop
drowning|drown
drumming|drum
drying|dry
ducking|duck
easing|ease
eating|eat
edging|edge
emptying|empty
evening|even
facing|face
fanning|fan
farming|farm
fattening|fatten
fending|fend
fetching|fetch
filing|file
filling|fill
filtering|filter
firing|fire
firming|firm
fishing|fish
flaring|flare
flattening|flatten
flipping|flip
floating|float
flooding|flood
flunking|flunk
flushing|flush
flying|fly
folding|fold
following|follow
fouling|foul
freaking|freak
freezing|freeze
freshening|freshen
fucking|fuck
fueling|fuel
galloping|gallop
gathering|gather
glazing|glaze
gobbling|gobble
grinding|grind
gulping|gulp
hacking|hack
hammering|hammer
hanging|hang
hanging|hang
hauling|haul
heading|head
healing|heal
heating|heat
herding|herd
hiding|hide
hiking|hike
hitching|hitch
hooking|hook
hopping|hop
hunting|hunt
ironing|iron
jamming|jam
jerking|jerk
joining|join
jumbling|jumble
jumping|jump
knocking|knock
knotting|knot
lapping|lap
lashing|lash
leading|lead
leaking|leak
leaning|lean
leaping|leap
leaping|leap
leveling|level
licking|lick
lighting|light
lightening|lighten
limbering|limber
lining|line
livening|liven
logging|log
loosening|loosen
losing|lose
marrying|marry
matching|match
melting|melt
messing|mess
missing|miss
mopping|mop
mouthing|mouth
moving|move
mucking|muck
nodding|nod
oozing|ooze
opening|open
packing|pack
pairing|pair
panning|pan
peeling|peel
piling|pile
pissing|piss
playing|play
ploughing|plough
plowing|plow
plucking|pluck
plunging|plunge
pointing|point
poking|poke
popping|pop
pounding|pound
pouring|pour
prying|pry
puckering|pucker
pulling|pull
pumping|pump
quieting|quiet
raking|rake
reaching|reach
reeling|reel
renting|rent
reving|rev
riding|ride
ringing|ring
ringing|ring
ripping|rip
rocking|rock
rolling|roll
rooting|root
rounding|round
rubbing|rub
running|run
rushing|rush
scouting|scout
scraping|scrape
scratching|scratch
screwing|screw
sealing|seal
serving|serve
settling|settle
sewing|sew
shaping|shape
shaving|shave
shifting|shift
shipping|ship
shooting|shoot
shorting|short
shrugging|shrug
shushing|shush
signing|sign
shutting|shut
sketching|sketch
skipping|skip
slipping|slip
slowing|slow
smartening|smarten
smashing|smash
smoothing|smooth
snapping|snap
snatching|snatch
sneaking|sneak
sniffing|sniff
snuffing|snuff
soaking|soak
sobering|sober
softening|soften
spacing|space
sparking|spark
speeding|speed
speeding|speed
spelling|spell
spelling|spell
spilling|spill
spinning|spin
spitting|spit
splitting|split
spreading|spread
springing|spring
sprouting|sprout
sprucing|spruce
squaring|square
squeezing|squeeze
squirting|squirt
staggering|stagger
stamping|stamp
starring|star
starving|starve
steaming|steam
sticking|stick
stiffening|stiffen
stirring|stir
stocking|stock
storming|storm
straightening|straighten
stretching|stretch
striking|strike
stripping|strip
sucking|suck
summing|sum
swelling|swell
swinging|swing
switching|switch
tallying|tally
tangling|tangle
tapering|taper
thickening|thicken
thinning|thin
ticking|tick
tidying|tidy
tightening|tighten
tipping|tip
tiring|tire
toning|tone
toppling|topple
tossing|toss
trailing|trail
treading|tread
trimming|trim
tripping|trip
tucking|tuck
tuning|tune
twisting|twist
typing|type
waking|wake
warming|warm
weaving|weave
weeding|weed
weighing|weigh
whipping|whip
whooping|whoop
winning|win
winding|wind
wiping|wipe
working|work
wrapping|wrap
auctioning|auction
bandying|bandy
barring|bar
battening|batten
biting|bite
blocking|block
blotting|blot
blowing|blow
blurting|blurt
boarding|board
booking|book
booting|boot
bottling|bottle
bundling|bundle
buttering|butter
caging|cage
carrying|carry
carting|cart
chalking|chalk
chasing|chase
chucking|chuck
cleaning|clean
cluttering|clutter
covering|cover
cranking|crank
cutting|cut
damming|dam
dishing|dish
dividing|divide
doling|dole
dredging|dredge
drinking|drink
dumping|dump
egging|egg
eking|eke
factoring|factor
faxing|fax
flinging|fling
flinging|fling
fixing|fix
fobbing|fob
gouging|gouge
hamming|ham
hashing|hash
hoisting|hoist
jacking|jack
jazzing|jazz
jotting|jot
kicking|kick
killing|kill
laying|lay
lifting|lift
linking|link
loading|load
locking|lock
lopping|lop
mailing|mail
mapping|map
marking|mark
meting|mete
mixing|mix
mulling|mull
mussing|muss
nailing|nail
palming|palm
patching|patch
paving|pave
penning|pen
phasing|phase
phoning|phone
picking|pick
piecing|piece
pinning|pin
plugging|plug
pricking|prick
propping|prop
punching|punch
pushing|push
racking|rack
reining|rein
rigging|rig
riling|rile
rinsing|rinse
roughing|rough
roughening|roughen
saving|save
scaling|scale
scaring|scare
shaking|shake
shoring|shore
singling|single
sizing|size
skimming|skim
smuggling|smuggle
sopping|sop
sorting|sort
spicing|spice
stacking|stack
staking|stake
staving|stave
stringing|string
stringing|string
stuffing|stuff
sussing|suss
sweeping|sweep
tacking|tack
taping|tape
tearing|tear
throwing|throw
tiding|tide
tying|tie
topping|top
totaling|total
touching|touch
toughening|toughen
tracking|track
wadding|wad
washing|wash
wearing|wear
wringing|wring
yanking|yank
zipping|zip
acknowledging|acknowledge
adding|add
admitting|admit
affirming|affirm
agreeing|agree
announcing|announce
arguing|argue
ascertaining|ascertain
asserting|assert
assuming|assume
believing|believe
bragging|brag
calculating|calculate
charging|charge
claiming|claim
commanding|command
commenting|comment
complaining|complain
conceding|concede
concluding|conclude
confessing|confess
confirming|confirm
contending|contend
deciding|decide
declaring|declare
deducing|deduce
determining|determine
discerning|discern
disclosing|disclose
discovering|discover
emphasizing|emphasize
envisioning|envision
exclaiming|exclaim
explaining|explain
figuring|figure
guessing|guess
hinting|hint
hoping|hope
implying|imply
inquiring|inquire
insisting|insist
intimating|intimate
learning|learn
maintaining|maintain
musing|muse
muttering|mutter
noting|note
observing|observe
ordering|order
pledging|pledge
postulating|postulate
predicting|predict
presuming|presume
proclaiming|proclaim
promising|promise
proposing|propose
proving|prove
reading|read
realizing|realize
reasoning|reason
recalling|recall
reckoning|reckon
recognizing|recognize
recounting|recount
reflecting|reflect
remarking|remark
remembering|remember
repeating|repeat
replying|reply
reporting|report
resolving|resolve
responding|respond
retorting|retort
revealing|reveal
ruling|rule
shouting|shout
sighing|sigh
speculating|speculate
stating|state
stipulating|stipulate
stressing|stress
suggesting|suggest
testifying|testify
theorizing|theorize
thinking|think
threatening|threaten
warning|warn
whispering|whisper
wondering|wonder
writing|write
relating|relate
continuing|continue
